© Perfect World Adapted from Persona 5 © ATLUS. © SEGA.\nSpecial Thanks: Fontworks Inc. and SHOWASHOTAI Co., Ltd.\nClient Version:=© Perfect World Адаптирован на основе Persona 5 © ATLUS. © SEGA. \nОсобая благодарность: Fontworks Inc., SHOWASHOTAI Co. Ltd. \nи <u><size\=25>@garry4444</size></u>, а так же <u><size\=25>@OTTYSS</size></u> за подготовленный руссификатор игры \nВерсия клиента:
Copyright: Perfect World Investment & Holding Group. Publisher: Perfect World Investment & Holding Group.\nLicense Number: National New Examination [2022] #1630. Publication Number: ISBN978-7-498-08007-3 Version: =Авторские права: Perfect World Investment & Holding Group. Издатель: Perfect World Investment & Holding Group.\nРусифицировали проект: @garry4444, а так же @OTTYSS.\nЛицензия: Национальный номер экзамена [2022] №1630. ISBN: 978-7-498-08007-3 Версия: 
ID:=ID:
Lv.=Lv.

© Perfect World Adapted from Persona 5 © ATLUS. © SEGA.\nSpecial Thanks: Fontworks Inc. and SHOWASHOTAI Co., Ltd.=© Perfect World Адаптирован на основе Persona 5 © ATLUS. © SEGA.\nОсобая благодарность: Fontworks Inc., SHOWASHOTAI Co. Ltd. \nи <u><size\=25>@garry4444</size></u>, а так же <u><size\=25>@OTTYSS</size></u> за подготовленный руссификатор игры
\nClient Version: =\nВерсия клиента: 
Game Version: =Версия игры: 
.Resource No.: =Номер ресурса: 


// PERSONA NAMES //=// ИМЕНА ПЕРСОН //
Janosik=Яношик
Jánošík=Яношик
Robroy=Роброй
Awilda=Авильда
Mandrin=Мандрин
Mandrin=Мандрин
Chiyome=Чиёме
Ghino=Гино
Michael=Майкл
Uriel=Уриэль
Uriel=Уриэль
Raphael=Рафаэль
Gabriel=Габриэль
Lucifer=Люцифер
Satan=Сатана
Metatron=Метатрон
Throne=Трон
Dominion=Доминион
Power=Сила
Principality=Принципат
Archangel=Архангел
Kohryu=Кохрю
Seiryu=Сейрю
Byakko=Бякко
Suzaku=Судзаку
Genbu=Генбу
Jikokuten=Дзикокутэн
Zouchouten=Зоучотэн
Koumokuten=Коумокутэн
Bishamonten=Бишамонтэн
Bishamonten=Бишамонтэн
Asura=Асура
Pale Rider=Бледный всадник
White Rider=Белый всадник
Red Rider=Красный всадник
Black Rider=Чёрный всадник
Atropos=Атропос
Lachesis=Лахесис
Clotho=Клото
Black Frost=Чёрный Фрост
King Frost=Король Фрост
Jack Frost=Джек Фрост
Jack-o'-Lantern=Джек-фонарь
Regent=Регент
Queen's Necklace=Королевское ожерелье
Stone of Scone=Камень Скоун
Koh-i-Noor=Кох-и-Нор
Orlov=Орлов
Emperor's Amulet=Амулет Императора
Hope Diamond=Алмаз Надежды
Crystal Skull=Кристальный Череп
Kin-Ki=Кин-Ки
Sui-Ki=Суй-Ки
Fuu-Ki=Фуу-Ки
Ongyo-Ki=Онгё-Ки
Ara Mitama=Ара Митама
Nigi Mitama=Ниги Митама
Kusi Mitama=Куси Митама
Saki Mitama=Саки Митама
Tam Lin=Там Лин
Setanta=Сетанта
Cu Chulainn=Ку Чулайн
Leanan Sidhe=Леанан Сид
Garuda=Гаруда
Jatayu=Джатайю
Horus=Гор
Yatagarasu=Ятагарасу
Thoth=Тот
Thoth=Тот
Agathion=Агатион
Eligor=Элигор
Decarabia=Декорабия
Mithra=Митра
Kikuri-Hime=Кикури-Химе
Daisoujou=Дайсодзю
Okuninushi=Окунинуси
Narcissus=Нарцисс
Unicorn=Единорог
Anubis=Анубис
Flauros=Флаурос
Rakshasa=Ракшаса
Sandman=Сэндмен
Orthrus=Орфрус
Neko Shogun=Нэко Сёгун
Ame-no-Uzume=Аме-но-Узуме
Shiki-Ouji=Сики-Оудзи
Lamia=Ламия
Queen Mab=Королева Маб
Sarasvati=Сарасвати
Hell Biker=Адский Байкер
Onmoraki=Онмораки
Surt=Сурт
Matador=Матадор
Ose=Осе
Oberon=Оберон
Titania=Титания
Titania=Титания
Thunderbird=Громовержец
Thunderbird=Громовержец
Phoenix=Феникс
Yaksini=Якшини
Nebiros=Небирос
Quetzalcoatl=Кецалькоатль
Anzu=Анзу
Cerberus=Цербер
Hariti=Харити
Black Ooze=Чёрная слизь
Lilim=Лилим
Alice=Алиса
Arahabaki=Арахабаки
Take-Minakata=Такэ-Минаката
Lakshmi=Лакшми
Mokoi=Мокои
Mothman=Мотман
Kaiwan=Кайван
Mithras=Митра
Norn=Норн
Fortuna=Фортуна
Fortuna=Фортуна
Raja Naga=Раджа Наги
Naga=Нага
Seth=Сет
Belphegor=Белфегор
Barong=Баронг
Dakini=Дакни
Ganesha=Ганеша
Yurlungur=Юрлунгур
Bugs=Багз
Hecatoncheires=Гекатонхейр
Kushinada-Hime=Кушинада-Химе
Odin=Один
Thor=Тор
Kumbhanda=Кумбханда
Yamata-no-Orochi=Ямато-но-Орочи
Pazuzu=Пазузу
Belial=Валиал
Valkyrie=Валькирия
High Pixie=Высокая пикси
Pixie=Пикси
Girimehkala=Гиримехкала
Mandrake=Мандрагора
Moloch=Молох
Baphomet=Бафомет
Hua Po=Хуа По
Skadi=Скади
Rangda=Рангда
Scathach=Скатах
Koropokkuru=Коропоккуру
Kelpie=Келпи
Andras=Андрас
Bicorn=Бикорн
Incubus=Инкуб
Inugami=Инугами
Makami=Маками
Koppa Tengu=Коппа Тэнгу
Kurama Tengu=Курама Тэнгу
Orobas=Оробас
Nekomata=Нэкомата
Nekomata=Нэкомата
Kodama=Кодама
Shiisaa=Шииса
Slime=Слизь
Silky=Силки
Succubus=Суккуб
Obariyon=Обарион
Berith=Берит
Ippon-Datara=Иппон-Датара
Sudama=Судама
Isis=Исида
Isis=Исида
Melchizedek=Мельхиседек
Atavaka=Атавака
Vishnu=Вишну
Yatsufusa=Яцусуса
Yoshitsune=Ёситсунэ
Futsunushi=Фуцунуши
Mara=Мара
Lilith=Лилит
Chernobog=Чернобог
Ardhanari=Ардханари
Ardha=Ардха
Shiva=Шива
Parvati=Парвати
Dionysus=Дионис
Dionysus=Дионис
Sandalphon=Сандалфон
Sandalphon=Сандалфон
Nidhoggr=Нидхогг
Kartikeya=Карттикея
Oumitsunu=Оумитсуно
Mada=Мада
Sraosha=Сраоша
Macabre=Макарбр
Fafnir=Фафнир
Pisaca=Писаса
Choronzon=Хорозон
Legion=Легион
Ananta=Ананта
Mishaguji=Мишагудзи
Kali=Кали
Forneus=Форнеус
Forneus=Форнеус
Hanuman=Хануман
Trumpeter=Трубач
Vasuki=Васуки
Byakhee=Бьякхи
Mot=Мот
Loa=Лоа
Chimera=Химера
Abadon=Абадон
Abadon=Абадон
Vohu Manah=Воху Мана
Zaou-Gongen=Зао-Гонген
Alilat=Алилат
Baal Zebul=Баал Зебул
Ayamur=Аямур
Baal=Баал
Cybele=Кибела
Hastur=Хастур
Siegfried=Зигфрид
Ishtar=Иштар
Mother Harlot=Мать Блудница
Beelzebub=Вельзевул
Chi You=Чи Юй
Maria=Мария
Maria=Мария
Nian=Нян
