A = А
B = Б
C = С
D = Д
E = Е
F = Ф
G = Г
H = Х
I = И
J = Дж
K = К
L = Л
M = М
N = Н
O = О
P = П
Q = К
R = Р
S = С
T = Т
U = Ю
V = В
W = В
X = Кс
Y = И
Z = З
a = а
b = б
c = с
d = д
e = е
f = ф
g = г
h = х
i = и
j = дж
k = к
l = л
m = м
n = н
o = о
p = п
q = к
r = р
s = с
t = т
u = ю
v = в
w = в
x = кс
y = и
z = з