A girl is standing silently in the square, wishing she had the courage to start singing...=Девочка стоит в тишине на площади, желая набраться смелости, чтобы начать петь...
Décor NPC (Male) - Non-Interactable=Декорация NPC (мужчина) — не взаимодействует
Décor NPC (Female) - Non-Interactable=Декорация NPC (женщина) — не взаимодействует
Décor NPC (Male) - Interactable=Декорация NPC (мужчина) — взаимодействует
Décor NPC (Female) - Interactable=Декорация NPC (женщина) — взаимодействует
All soccer players are welcome, from beginners to experienced veterans. Come work up a sweat and have fun honing your skills!=Приглашаются все футболисты — от новичков до опытных ветеранов. Приходите попотеть и насладиться тренировками!
The leader of the Band Club. Plays keyboard.\nResponsible and musically gifted.=Лидер музыкального клуба. Играет на клавишных.\nОтветственный и музыкально одарённый.
Join Band Club Practice=Присоединиться к тренировке музыкального клуба
Vice President & Keyboardist=Вице-президент и клавишник
Place Item=Положить предмет
Operator=Оператор
Worker=Рабочий
Museum Guard=Охранник музея
Bank Guard=Охранник банка
Supervisor=Супервизор
Akashi's Palace Ruler=Правитель дворца Акаши
Fortune Teller=Предсказательница
A resort beach that hasn't yet been fully developed into a tourist destination.\nThe view is gorgeous, but it's never too crowded.=Курортный пляж, ещё не полностью освоенный как туристическое место.\nВид прекрасен, но здесь никогда не бывает слишком многолюдно.
The busiest spot at Shirosato Beach.\nThis highly acclaimed beachside restaurant\nserves a diverse range of cuisine.=Самое оживлённое место на пляже Сиросато.\nЭтот высоко оценённый прибрежный ресторан\nпредлагает разнообразные блюда.
Aim for the bullseye!\nEnjoy some water gun shooting on the beach,\nand win amazing prizes!=Попадите в яблочко!\nНасладитесь стрельбой из водяных пистолетов на пляже\nи выиграйте потрясающие призы!
Something strange is going on!\nDefeat the Shadows lurking on the beach, and bring the crowds back to Shirosato Beach!=Что-то странное происходит!\nПобедите Теней, скрывающихся на пляже, и верните толпы на пляж Сиросато!
An elegant and talented puppet show performer. She particularly loves stories about mermaids.=Элегантная и талантливая кукольница. Особенно любит истории о русалках.
Standing out with his dyed hair and snazzy suit, Tetsunojou Shishida is hanging around in Shinjuku's red-light district. He's definitely up to something...=Выделяющийся крашеными волосами и стильным костюмом, Тэцунодзё Сисида бродит по кварталу красных фонарей в Синдзюку. Он явно что-то замышляет...
Jewelry Shop Employee=Сотрудник ювелирного магазина
Jewelry Shop Owner=Владелец ювелирного магазина
Jewelry Shop Proprietress=Владелица ювелирного магазина
Allows you to buy capsule toys.=Позволяет покупать капсульные игрушки
Nightmare's Gateway Entrance=Вход в Врата Кошмаров
Mysterious Selfie Machine=Таинственный автомат для селфи
Guild Main Screen Entrance=Вход в главное меню гильдии
An electric town where you can find everything from home appliances to various components, coexisting with subcultures like maid cafés.=Электронный город, где можно найти всё — от бытовой техники до различных комплектующих, сосуществующий с субкультурами, такими как мейд-кафе.
Arcade-Loving Student=Студент, любящий аркадные игры
Allows you to study.=Позволяет заниматься учёбой
A bed where you can rest easy.\nYou can sleep here at night.=Кровать, где можно спокойно отдохнуть.\nЗдесь можно спать ночью.
Allows you to change your clothes.=Позволяет переодеться
Return to Path of Qimranut from Side Mission 1=Вернуться на Путь Кимранута из побочного задания 1
Return to Path of Qimranut from Side Mission 3=Вернуться на Путь Кимранута из побочного задания 3
Return to Path of Qimranut from Yuta Sato's Side Mission=Вернуться на Путь Кимранута из побочного задания Юты Сато
Return to Path of Qimranut from Side Mission 5=Вернуться на Путь Кимранута из побочного задания 5
Return to Path of Qimranut from Side Mission 6=Вернуться на Путь Кимранута из побочного задания 6
Return to Path of Qimranut from Side Mission 7=Вернуться на Путь Кимранута из побочного задания 7
Return to Path of Qimranut from Side Mission 9=Вернуться на Путь Кимранута из побочного задания 9
Batting Cages (Locked)=Биты для отбивания (закрыто)
Placeholder Cat Figure=Фигура кота-заполнителя
Intriguing Building=Интригующее здание
Old Apartment=Старый жилой дом
Residential District=Жилой район
Tobacco Store=Табачный магазин
Izakaya=Изакая (японский бар)
Dining Bar=Ресторан-бар
International Restaurant=Международный ресторан
Stacked Ingredients=Сложенные ингредиенты
Postbox=Почтовый ящик
Listen to conversation=Послушать разговор
Girl Collecting Donations=Девочка, собирающая пожертвования
Yellow Cat=Жёлтый кот
Gray Cat=Серый кот
Black and White Cat=Чёрно-белый кот
Apartment Exterior Wall=Фасад жилого дома
Supermarket Employee=Сотрудник супермаркета
Solitary Old Man=Одинокий старик
Man in a Suit=Мужчина в костюме
Bored Man=Скучающий мужчина
Interrogation Room Guard=Охранник допросной комнаты
Resident=Житель
Station=Станция
Mysterious Traces=Таинственные следы
Orthopedic Clinic=Ортопедическая клиника
Laundromat=Прачечная
Tabby's Treasure Hunt=Охота за сокровищами Табби
Go to Yongen-Jaya=Отправиться в Ёнгэн-Джяя
No Entry=Вход запрещён
Cheerful Punk=Весёлый панк
Cheerful Girl=Весёлая девочка
Artistic Boy=Художественный мальчик
Honor Student-like Girl=Девочка, похожая на отличницу
Girl Wearing Glasses=Девочка в очках
Courteous Girl=Вежливая девочка
Coffee=Кофе
Empty Curry Plate=Пустая тарелка карри
Textbook=Учебник
Languid Doctor=Вялый доктор
Yongen-Jaya (Night)=Ёнгэн-Джяя (ночь)
Thieving Cat's Footprints 1=Следы вора-кота 1
Thieving Cat's Footprints 2=Следы вора-кота 2
Thieving Cat's Footprints 3=Следы вора-кота 3
Café Signboard=Вывеска кафе
Shadow Soldier=Теневая боец
Shadow Security Guard=Теневой охранник
Shadow Lord=Теневой лорд
Buchiko Statue=Статуя Бучико
Girl with a Guitar=Девочка с гитарой
Girl with a Donation Box=Девочка с коробкой для пожертвований
Gym=Спортзал
Guitar Case=Чехол для гитары
Smoking Area=Место для курения
Lottery Stand=Лотерейный стенд
Karaoke=Караоке
Frequent Lottery Customer=Постоянный клиент лотереи
Listen to audience=Послушать аудиторию
Frequent Customer=Постоянный клиент
Lethargic Female Clerk=Вялая продавщица
Gloomy Hall Manager=Угрюмый управляющий залом
Kind Old Man=Добрый старик
Rough Man=Грубый мужчина
Man with Large Muscles=Мужчина с большими мускулами
Map of Shibuya=Карта Сибуя
Newspaper Stand Regular=Постоянный продавец газет
Monjayaki=Моня-яки (блюдо)
Coffee Chain=Сеть кофеен
Crossing Drugstore=Аптека на перекрёстке
Pay Phone=Платный телефон
Locker=Шкафчик
Event Tent=Палатка для мероприятий
Middle-Aged Employee=Сотрудник среднего возраста
Yuna=Юна
Kyo=Кё
Haruna's Mother=Мать Харуна
Shota Ito=Шота Ито
Woman in Kimono=Женщина в кимоно
Man with a Camera=Мужчина с камерой
Scary-Looking Man=Пугающий мужчина
Expressionless Man=Безэмоциональный мужчина
Flyer in front of the bookstore=Листовка перед книжным магазином
Go to the hallway=Идти в коридор
Mellow Student=Спокойный студент
Undecided Student=Нерешительный студент
Unmotivated Student=Не мотивированный студент
Bored Student=Скучающий студент
Languid Student=Вялый студент
Giant Impact Club (Bored Student)=Клуб гигантского удара (скучающий студент)
Seat=Место
Blackboard=Доска
Gossip-Loving Student=Студент, любящий сплетни
Dispassionate Student=Бесстрастный студент
Curious Student=Любопытный студент
Composed Student=Сдержанный студент
Daydreaming Student=Мечтательный студент
Tired Student=Уставший студент
Whispering Students=Шепчущие студенты
Quietly Arguing Student=Спокойно спорящий студент
Loudly Arguing Student=Громко спорящий студент
Cautious Student=Осторожный студент
Slightly Tired Student=Немного усталый студент
Giant Impact Club (Loudly Arguing Student)=Клуб гигантского удара (громко спорящий студент)
Giant Impact Club (Murmuring Student)=Клуб гигантского удара (бормочущий студент)
Rumor-Obsessed Student=Студент, одержимый слухами
Uninterested Student=Не заинтересованный студент
Gourmand Student=Гурман студент
Motivated Student=Мотивированный студент
Baseball-Loving Student=Студент, любящий бейсбол
Reserved Student=Сдержанный студент
Giant Impact Club (Gourmand Student)=Клуб гигантского удара (гурман студент)
Nodding Student=Кивающий студент
Free-Thinking Student=Свободомыслящий студент
Independent Student=Независимый студент
Fun-Loving Student=Любящий веселье студент
Cool-Headed Student=Хладнокровный студент
Morning Chime=Утренний звонок
Lunch Chime=Звонок на обед
After School Chime=Звонок после школы
Trend-Following Student=Студент, следующий моде
Festival-Loving Student=Студент, любящий фестивали
Apathetic Student=Аппатичный студент
Philosophical Student=Философский студент
Lone Wolf Student=Одинокий волк студент
Sociable Student=Общительный студент
Serious Student=Серьёзный студент
Rowdy Student=Шумный студент
Quiet Student=Тихий студент
Vigilant Student=Бдительный студент
Classroom: Morning=Класс: утро
Classroom: Afternoon=Класс: день
Classroom: Evening=Класс: вечер
Classroom: Night=Класс: ночь
Background Student - Male=Фоновый студент - мужчина
Background Student - Female=Фоновый студент - женщина
Change your shoes=Поменять обувь
Box on top of the shoe locker=Коробка на обувном шкафу
Boys Near the Stairs=Мальчики у лестницы
Girls Near the Stairs=Девочки у лестницы
Shouting Students=Кричащие студенты
Student near Window=Студент у окна
Forgetful Boy=Забывчивый мальчик
Bulletin Board=Доска объявлений
Outdoor Shoe Students=Студенты с уличной обувью
Cabinet=Шкаф
Students in Corner=Студенты в углу
Girl Looking at Bulletin Board=Девочка, смотрящая на доску объявлений
Go to the practice building=Идти в тренировочный корпус
Go to the classroom building=Идти в учебный корпус
Leave the school=Покинуть школу
Girls' Bathroom=Туалет для девочек
Go to the gymnasium=Идти в спортзал
Depressed Boy=Подавленный мальчик
Mellow Boy=Спокойный мальчик
Girl Looking Afar=Девочка, смотрящая вдаль
Concerned Girl=Обеспокоенная девочка
Nonchalant Girl=Безразличная девочка
Nodding Girl=Кивающая девочка
Ecstatic Girl=Восторженная девочка
Jealous Girl=Ревнивая девочка
Go to 1F=Идти на 1 этаж
Go to 3F=Идти на 3 этаж
Enter the classroom=Войти в класс
Boys in the Hallway=Мальчики в коридоре
Chatting Boys=Болтающие мальчики
Chatting Students=Болтающие студенты
Students near Window=Студенты у окна
Posing Boy=Мальчик, позирующий
Troubled Girl=Обеспокоенная девочка
Large Window=Большое окно
Newspaper Club Girl=Девочка из газетного клуба
Listen in=Подслушать
Newspaper Club Boy=Мальчик из газетного клуба
Perceptive Student=Восприимчивый студент
Airsoft-Loving Student=Студент, любящий страйкбол
Bubbly Student=Жизнерадостный студент
Academy Interior=Интерьер академии
Academy Gate=Ворота академии
Classroom Bldg=Учебный корпус
School Gate=Школьные ворота
Garbage Area=Мусорная зона
Students by the Flowerbed=Студенты у клумбы
Fire Hydrant=Пожарный гидрант
Chatting Girl=Болтающая девочка
Student by the Blackboard=Студент у доски
Students by the Bench=Студенты у скамейки
Students by the Wall=Студенты у стены
Road=Дорога
Momoko Sakurai=Момоко Сакураи
Event Announcements=Объявления о мероприятиях
Band Club - Recruiting New Members=Музыкальный клуб — набор новых участников
Bookshelf=Книжная полка
Printer=Принтер
Décor Male Student 1=Декорация мужской студент 1
Décor Male Student 2=Декорация мужской студент 2
Décor Male Student 3=Декорация мужской студент 3
Décor Male Student 4=Декорация мужской студент 4
Décor Male Student 5=Декорация мужской студент 5
Décor Male Student 6=Декорация мужской студент 6
Décor Male Student 7=Декорация мужской студент 7
Décor Male Student 8=Декорация мужской студент 8
Décor Male Student 9=Декорация мужской студент 9
Décor Female Student 1=Декорация женский студент 1
Décor Female Student 2=Декорация женский студент 2
Décor Female Student 3=Декорация женский студент 3
Décor Female Student 4=Декорация женский студент 4
Décor Female Student 5=Декорация женский студент 5
Décor Female Student 6=Декорация женский студент 6
Décor Female Student 7=Декорация женский студент 7
Décor Female Student 8=Декорация женский студент 8
Décor Female Student 9=Декорация женский студент 9
Décor Female Student 10=Декорация женский студент 10
Décor Female Student 11=Декорация женский студент 11
Décor Female Student 12=Декорация женский студент 12
Décor Female Student 13=Декорация женский студент 13
Décor Female Student 14=Декорация женский студент 14
Décor Female Student 15=Декорация женский студент 15
Library=Библиотека
Ayasa Takanashi (Discard)=Аяса Таканаши (удалено)
Band Club (Discard)=Музыкальный клуб (удалено)
Tsurumi Horikita=Цуруми Хорикита
Taiko Saito=Тайко Сайто
Talking Students=Говорящие студенты
Arguing Students=Спорящие студенты
Classroom Bldg 3F=Учебный корпус 3 этаж
Kokatsu Academy Female Student 01=Студентка академии Кокатсу 01
Kokatsu Academy Female Student 02=Студентка академии Кокатсу 02
Kokatsu Academy Female Student 03=Студентка академии Кокатсу 03
Kokatsu Academy Female Student 04=Студентка академии Кокатсу 04
Kokatsu Academy Female Student 05=Студентка академии Кокатсу 05
Electric Piano=Электрическое пианино
Drum Set=Ударная установка
Omotesando=Омотэсандо
Yakitori Stand=Ларёк с якитори
File=Файл
Over the Wall=За стеной
Heritage Kitchen Door=Дверь в кухню наследия
Heritage Kitchen: Closed=Кухня наследия: закрыто
Heritage Kitchen: Open=Кухня наследия: открыто
Bakery=Пекарня
Sweets Shop=Кондитерская
Flowers in Bloom=Цветы в цвету
Lady Eyeing the Info Desk=Леди, смотрящая на стойку информации
Snack Bar=Закусочная
Narrow Stairs=Узкая лестница
Restaurant=Ресторан
Veterinary Hospital=Ветеринарная клиника
Cleaners=Химчистка
Diligent Businessman=Старательный бизнесмен
Empty Corner=Пустой угол
Platform=Платформа
Old Man=Старик
Suspicious Businessman=Подозрительный бизнесмен
Girl with Ponytail=Девочка с хвостиком
Kid Playing Alone=Ребёнок, играющий один
Kids=Дети
Hiroto=Хирото
Hiroto's Mother=Мать Хирото
Wait for Minami=Ждать Минами
Notice of Closure=Уведомление о закрытии
Spectator 1=Зритель 1
Spectator 2=Зритель 2
Spectator 3=Зритель 3
Spectator 4=Зритель 4
Spectator 5=Зритель 5
Spectator 6=Зритель 6
Spectator 7=Зритель 7
Spectator 8=Зритель 8
Spectator 9=Зритель 9
Spectator 10=Зритель 10
Host=Хозяин
Pedestrian Zone=Пешеходная зона
Shinmyoji=Синмёдзи
Jazz Club=Джаз-клуб
Darts & Billiards=Дартс и бильярд
Open Café=Открытое кафе
Information Desk=Стенд информации
Snack Shop=Закусочная
Bank=Банк
Hat Store=Магазин шляп
Revolving Sushi Restaurant=Ресторан суши с вращающейся лентой
Cell Phone Shop=Магазин мобильных телефонов
Taiyaki Shop=Магазин тайяки
Sock Shop=Магазин носков
Ice Cream Shop=Мороженое
Realtor=Риелтор
Shopping District Center=Центр торгового района
Udon Shop=Магазин удона
Asian Grocery=Азиатский гастроном
Furniture Store=Мебельный магазин
Ramen Shop=Рамен-магазин
Record Shop=Магазин пластинок
Music Store=Музыкальный магазин
Pasta Shop=Магазин пасты
Bicycle Store=Магазин велосипедов
Imported Toy Store=Магазин импортных игрушек
Wine Bar=Винный бар
Steakhouse=Стейкхаус
Antique Shop=Антикварный магазин
Outdoor Goods Shop=Магазин товаров для улицы
Donut Shop=Магазин пончиков
Glasses Shop=Магазин очков
To the station=К станции
Colorful Lights=Яркие огни
Sofa=Диван
Tree=Дерево
Bus Stop=Остановка автобуса
Graffiti on Wall=Граффити на стене
Miyu's Box=Коробка Мию
Miyu's Handbag=Сумочка Мию
Unenthusiastic Man=Неэнтузиазированный мужчина
Picky Traveler=Привередливый путешественник
Student-like Girl=Девочка, похожая на студентку
Passionate Guide=Страстный гид
Harris=Харрис
Ghostly Customer=Призрачный клиент
Hidden Place=Скрытое место
Neko Takahashi=Неко Такахаши
North Passage Destructible Point 01=Разрушаемая точка северного прохода 01
North Passage Destructible Point 02=Разрушаемая точка северного прохода 02
North Passage Destructible Point 03=Разрушаемая точка северного прохода 03
North Passage Destructible Point 04=Разрушаемая точка северного прохода 04
North Passage Destructible Point 05=Разрушаемая точка северного прохода 05
North Passage Destructible Point 06=Разрушаемая точка северного прохода 06
North Passage Destructible Point 07=Разрушаемая точка северного прохода 07
North Passage Destructible Point 08=Разрушаемая точка северного прохода 08
North Passage Destructible Point 09=Разрушаемая точка северного прохода 09
North Passage Destructible Point 10=Разрушаемая точка северного прохода 10
North Passage Destructible Point 11=Разрушаемая точка северного прохода 11
North Passage Destructible Point 12=Разрушаемая точка северного прохода 12
North Passage Destructible Point 13=Разрушаемая точка северного прохода 13
North Passage Destructible Point 14=Разрушаемая точка северного прохода 14
North Passage Destructible Point 15=Разрушаемая точка северного прохода 15
North Passage Destructible Point 16=Разрушаемая точка северного прохода 16
North Passage Destructible Point 17=Разрушаемая точка северного прохода 17
North Passage Destructible Point 18=Разрушаемая точка северного прохода 18
North Passage Destructible Point 19=Разрушаемая точка северного прохода 19
North Passage Destructible Point 20=Разрушаемая точка северного прохода 20
East Passage Destructible Point 01=Разрушаемая точка восточного прохода 01
East Passage Destructible Point 02=Разрушаемая точка восточного прохода 02
East Passage Destructible Point 03=Разрушаемая точка восточного прохода 03
East Passage Destructible Point 04=Разрушаемая точка восточного прохода 04
East Passage Destructible Point 05=Разрушаемая точка восточного прохода 05
East Passage Destructible Point 06=Разрушаемая точка восточного прохода 06
East Passage Destructible Point 07=Разрушаемая точка восточного прохода 07
East Passage Destructible Point 08=Разрушаемая точка восточного прохода 08
East Passage Destructible Point 09=Разрушаемая точка восточного прохода 09
East Passage Destructible Point 10=Разрушаемая точка восточного прохода 10
East Passage Destructible Point 11=Разрушаемая точка восточного прохода 11
East Passage Destructible Point 12=Разрушаемая точка восточного прохода 12
East Passage Destructible Point 13=Разрушаемая точка восточного прохода 13
East Passage Destructible Point 14=Разрушаемая точка восточного прохода 14
East Passage Destructible Point 15=Разрушаемая точка восточного прохода 15
East Passage Destructible Point 16=Разрушаемая точка восточного прохода 16
East Passage Destructible Point 17=Разрушаемая точка восточного прохода 17
East Passage Destructible Point 18=Разрушаемая точка восточного прохода 18
East Passage Destructible Point 19=Разрушаемая точка восточного прохода 19
East Passage Destructible Point 20=Разрушаемая точка восточного прохода 20
West Passage Destructible Point 01=Разрушаемая точка западного прохода 01
West Passage Destructible Point 02=Разрушаемая точка западного прохода 02
West Passage Destructible Point 03=Разрушаемая точка западного прохода 03
West Passage Destructible Point 04=Разрушаемая точка западного прохода 04
West Passage Destructible Point 05=Разрушаемая точка западного прохода 05
West Passage Destructible Point 06=Разрушаемая точка западного прохода 06
West Passage Destructible Point 07=Разрушаемая точка западного прохода 07
West Passage Destructible Point 08=Разрушаемая точка западного прохода 08
West Passage Destructible Point 09=Разрушаемая точка западного прохода 09
West Passage Destructible Point 10=Разрушаемая точка западного прохода 10
West Passage Destructible Point 11=Разрушаемая точка западного прохода 11
West Passage Destructible Point 12=Разрушаемая точка западного прохода 12
West Passage Destructible Point 13=Разрушаемая точка западного прохода 13
West Passage Destructible Point 14=Разрушаемая точка западного прохода 14
West Passage Destructible Point 15=Разрушаемая точка западного прохода 15
West Passage Destructible Point 16=Разрушаемая точка западного прохода 16
West Passage Destructible Point 17=Разрушаемая точка западного прохода 17
West Passage Destructible Point 18=Разрушаемая точка западного прохода 18
West Passage Destructible Point 19=Разрушаемая точка западного прохода 19
West Passage Destructible Point 20=Разрушаемая точка западного прохода 20
Trial Part 1=Часть испытания 1
Trial Part 2=Часть испытания 2
Trial Part 3=Часть испытания 3
Next Station=Следующая станция
Wandering Shadow=Бродячая Тень
Agitated Shadow=Взволнованная Тень
Savage Shadow=Дикая Тень
Treasure Demon=Демон сокровищ
Stubborn Shadow=Упрямая Тень
Train=Поезд
Gate NPC=NPC у ворот
Office Worker's Shadow=Тень офисного работника
Store Owner's Shadow=Тень владельца магазина
Girl's Shadow=Тень девочки
Boy's Shadow=Тень мальчика
Hesitant Man's Shadow=Тень нерешительного мужчины
Lonely Bench=Одинокая скамейка
Keen Saleslady Shadow=Тень увлечённой продавщицы
Sick Man's Shadow=Тень больного мужчины
Investor's Shadow=Тень инвестора
Finance Guru's Shadow=Тень финансового гуру
Hero-Loving Shadow=Тень, любящая героев
Ghostly Shadow=Призрачная Тень
Courier's Shadow=Тень курьера
Tough Guy's Shadow=Тень крепкого парня
Young Boy's Shadow=Тень мальчика
Freeloader Shadow=Тень нахлебника
Career-Seeking Shadow=Тень, ищущая карьеру
Gambling Addict Shadow=Тень азартного игрока
Gamer Boy's Shadow=Тень геймера-мальчика
Gamer Girl's Shadow=Тень геймерши
Gamer Grandpa's Shadow=Тень геймера-деда
Horse Racing Fan Shadow=Тень фаната скачек
Grumbling Man's Shadow=Тень ворчащего мужчины
Astrology Fan Shadow=Тень любителя астрологии
Liar's Shadow=Тень лжеца
Troubled Old Man Shadow=Тень обеспокоенного старика
Capable Girl Shadow=Тень способной девочки
Young Girl's Shadow=Тень молодой девочки
Maid's Shadow=Тень горничной
Motoha=Мотоха
Armored Guard=Бронированный охранник
Collab 1-5-2 Atmosphere NPC=Совместный NPC атмосферы 1-5-2
Collab 1-5-2 Patrol Enemy=Совместный патрульный враг 1-5-2
Collab 1-5-2 B Area Atmosphere NPC=Совместный NPC атмосферы области B 1-5-2
Story Performance Monster=Монстр в представлении истории
Surveillance=Наблюдение
Castle Soldier=Замковый солдат
Hidden Name NPC=Скрытый NPC по имени
Shadow Guard=Теневой охранник
Strong Enemy=Сильный враг
Treasure Chest Guards=Охранники сундуков с сокровищами
Check the bookshelf=Проверьте книжную полку
Baseball Pedestal=Подставка для бейсбола
Bird-Headed Shadow=Тень с головой птицы
Throne Room Door=Дверь в тронный зал
Treasure Hall Window=Окно зала сокровищ
Museum Security Guard=Охранник музея
Museum Elite Security=Элитная охрана музея
Patrolling Guard=Патрулирующий охранник
Security Room Door=Дверь охранной комнаты
Reception Room Guard=Охранник в приемной
Go to the Lower Level=Идти на нижний уровень
Connecting Room Door=Дверь соединяющей комнаты
Bank Guard Dog=Собака охраны банка
Open=Открыть
Lizard-Headed Shadow=Тень с головой ящерицы
Use Elevator=Использовать лифт
Treasure Chest Guard=Охранник сундука с сокровищами
Open Door=Открыть дверь
Controller=Контроллер
Shadow=Тень
Mandatory Main Quest Enemy 1=Обязательный враг основного задания 1
Mandatory Main Quest Enemy 2-1=Обязательный враг основного задания 2-1
Mandatory Main Quest Enemy 2-2=Обязательный враг основного задания 2-2
Mandatory Main Quest Enemy 2-3=Обязательный враг основного задания 2-3
Mandatory Main Quest Enemy 2-4=Обязательный враг основного задания 2-4
Research=Исследование
Mandatory Main Quest Enemy 2=Обязательный враг основного задания 2
Room 1 NPC=NPC в комнате 1
Spaceport - Mandatory Main Quest Enemy 1=Космопорт — обязательный враг основного задания 1
Enter=Войти
Chief=Начальник
Section Chief=Начальник отдела
Use Den Maker=Использовать Ден-Мейкер
Start Music Player=Запустить музыкальный плеер
View Gallery=Просмотреть галерею
View Sign=Посмотреть знак
Play Tycoon=Играть в тайкун
Watch Movie=Смотреть фильм
Illustration Not Unlocked=Иллюстрация не разблокирована
KV - Calling Card=КВ — визитная карточка
CBT3KV - Gun=CBT3KV — оружие
CBT3KV - Clash=CBT3KV — столкновение
OBKV - Heavy Paint=OBKV — тяжёлая краска
KV - Velvet Room=КВ — Бархатная комната
Check Rating=Проверить рейтинг
Check Item=Проверить предмет
Skull=Череп
Mona=Мона
Panther=Пантера
Ryuji Sakamoto - Group Conversation=Рюдзи Сакамото — групповая беседа
Morgana - Group Conversation=Моргана — групповая беседа
Motoha Arai - Group Conversation=Мотоха Араи — групповая беседа
Lufel - Group Conversation=Луфель — групповая беседа
Shun Kano - Group Conversation=Шун Каноу — групповая беседа
Leo Kamiyama - Group Conversation=Лео Камияма — групповая беседа
Kayo Tomiyama - Group Conversation=Кайо Томияма — групповая беседа
Yaoling Li - Group Conversation=Яолин Ли — групповая беседа
Tomoko Noge - Group Conversation=Томоко Ноге — групповая беседа
Kiyoshi Kurotani - Group Conversation=Киоши Куротани — групповая беседа
Yukimi Fujikawa - Group Conversation=Юкими Фудзикава — групповая беседа
Seiji Shiratori - Group Conversation=Сэйдзи Сиротори — групповая беседа
Toshiya Sumi - Group Conversation=Тошия Суми — групповая беседа
Ann Takamaki - Group Conversation=Анн Такамаки — групповая беседа
Kotone Montagne - Group Conversation=Котоне Монтанье — групповая беседа
Ren Amamiya - Group Conversation=Рен Амаамия — групповая беседа
Miyu Sahara - Group Conversation=Мию Сахара — групповая беседа
Haruna Nishimori - Group Conversation=Харуна Нисимори — групповая беседа
Leo Kamiyama & Kiyoshi Kurotani=Лео Камияма и Киоши Куротани
Tomoko Noge & Miyu Sahara=Томоко Ноге и Мию Сахара
Seiji Shiratori & Toshiya Sumi=Сэйдзи Сиротори и Тошия Суми
Joker & Shun Kano=Джокер и Шун Каноу
Skull & Shun Kano=Скалл и Шун Каноу
Panther & Motoha Arai=Пантера и Мотоха Араи
Shirosato Beach=Пляж Сиросато
Beach House=Дом на пляже
Leave the beach=Покинуть пляж
Seaside Temp Hideout=Временное убежище у моря
Motoha & Tomoko=Мотоха и Томоко
Motoha & Shun=Мотоха и Шун
Motoha & Riko=Мотоха и Рико
Shun & Lufel=Шун и Луфель
Riko & Shun=Рико и Шун
Riko & Lufel=Рико и Луфель
Tomoko (Not displayed)=Томоко (не отображается)
Shun (Not displayed)=Шун (не отображается)
Riko (Not displayed)=Рико (не отображается)
Lufel (Not displayed)=Луфель (не отображается)
Summer Ramen Event=Летнее событие рамэна
Yakisoba Chopsticks=Палочки для якисобы
Summer Yakisoba=Летний якисоба
Ramen Chopsticks=Палочки для рамэна
Beach Chair=Пляжный стул
Nightlife Center=Центр ночной жизни
Security Company=Охранная компания
Chinese Restaurant=Китайский ресторан
Adults-Only Store=Магазин только для взрослых
Pachinko Parlor=Пачинко-парлор
Pawn Shop=Ломбард
Pet Shop=Зоомагазин
Acupuncture Clinic=Клиника акупунктуры
Chihaya's Seat 1=Место Чихаи 1
Chihaya's Seat 2=Место Чихаи 2
Chihaya's Table - Card=Стол Чихаи — карта
Studly Host=Крутой хозяин
Talkative Clinic Employee=Разговорчивый сотрудник клиники
Timid Store Clerk=Застенчивый продавец
Timid Man=Застенчивый мужчина
Arrogant Man=Высокомерный мужчина
Bookstore Employee=Сотрудник книжного магазина
Performing Girl=Выступающая девочка
Boy=Мальчик
Boy's Mother=Мать мальчика
Suitcase=Чемодан
Handbag=Сумочка
Miyu's Sign=Знак Мию
Miyu's Mermaid Tail=Русалочий хвост Мию
Miyu's Suitcase=Чемодан Мию
Yakiniku Shop=Магазин якинику
Signboard=Вывеска
Empty Seat=Пустое место
Eel Shop=Магазин угря
Elevator Door=Дверь лифта
Unoccupied Bench=Свободная скамейка
Camera NPC 1=NPC с камерой 1
Camera NPC 2=NPC с камерой 2
Camera NPC 3=NPC с камерой 3
Hidden Café=Скрытое кафе
Heavy Drinker=Заядлый пьяница
Elevator=Лифт
Stairs=Лестница
Return to Shinjuku from Victory Kitchen=Вернуться в Синдзюку из Victory Kitchen
Side Mission 1\_Curved Rail=Побочное задание 1\_Изогнутая рельса
Side Mission 1\_Red Vortex=Побочное задание 1\_Красный вихрь
Side Mission 1\_Straight Rail=Побочное задание 1\_Прямая рельса
Side Mission 1\_Red Blood Vessel=Побочное задание 1\_Красный кровеносный сосуд
Event\_Temp\_Entrance\_Straight\_Rail=Событие\_Временный вход\_Прямая рельса
Event\_Temp\_Entrance\_Red\_Blood\_Vessel=Событие\_Временный вход\_Красный кровеносный сосуд
Event\_Temp\_Entrance\_Curved\_Rail=Событие\_Временный вход\_Изогнутая рельса
Event\_Temp\_Entrance\_Blue\_Vortex=Событие\_Временный вход\_Синий вихрь
Angry Shadow=Злая Тень
Metaverse - Merope=Метавселенная — Меропе
Depraved Shadow=Развращённая Тень
Realm of the Ruined=Царство Разрушенных
Event\_Temp\_Entrance\_2\_Straight\_Rail=Событие\_Временный вход 2\_Прямая рельса
Event\_Temp\_Entrance\_2\_Red\_Blood\_Vessel=Событие\_Временный вход 2\_Красный кровеносный сосуд
Return to Path of Qimranut Area 4=Вернуться на Путь Кимранута, зона 4
Miyazawa's Palace=Дворец Миядзава
Path\_Of\_Aiyatsbus\_Former\_Palace\_Entrance\_Curved\_Rail=Путь Айятсбуса\_Вход в бывший дворец\_Изогнутая рельса
Path\_of\_Aiyatsbus\_Former\_Palace\_Entrance\_Red\_Vortex=Путь Айятсбуса\_Вход в бывший дворец\_Красный вихрь
Path\_of\_Aiyatsbus\_Former\_Palace\_Entrance\_Straight\_Rail=Путь Айятсбуса\_Вход в бывший дворец\_Прямая рельса
Path\_of\_Aiyatsbus\_Former\_Palace\_Entrance\_Red\_Blood\_Vessel=Путь Айятсбуса\_Вход в бывший дворец\_Красный кровеносный сосуд
Elegant Fragrance=Элегантный аромат
Fleeing Shadow=Убегающая Тень
Pursuing Shadow=Преследующая Тень
Side\_Mission\_6\_Curved\_Rail=Побочное задание 6\_Изогнутая рельса
Side\_Mission\_6\_Red\_Vortex=Побочное задание 6\_Красный вихрь
Side\_Mission\_6\_Straight\_Rail=Побочное задание 6\_Прямая рельса
Side\_Mission\_6\_Red\_Blood\_Vessel=Побочное задание 6\_Красный кровеносный сосуд
Side\_Mission\_5\_Straight\_Rail=Побочное задание 5\_Прямая рельса
Side\_Mission\_5\_Red\_Blood\_Vessel=Побочное задание 5\_Красный кровеносный сосуд
Side\_Mission\_Curved\_Rail=Побочное задание\_Изогнутая рельса
Side\_Mission\_Red\_Vortex=Побочное задание\_Красный вихрь
Side\_Mission\_Straight\_Rail=Побочное задание\_Прямая рельса
Side\_Mission\_Red\_Blood\_Vessel=Побочное задание\_Красный кровеносный сосуд
Completed Equipment Plan=Завершённый план снаряжения
Equipment Parts=Детали снаряжения
Door to the Path of Aiyatsbus Closed=Дверь на Путь Айятсбуса закрыта
Path of Aiyatsbus Train Crossing=Переезд на Пути Айятсбуса
Path of Aiyatsbus Train Stopped=Поезд на Пути Айятсбуса остановлен
Return to Path of Aiyatsbus Area 4=Вернуться на Путь Айятсбуса, зона 4
Return to Path of Aiyatsbus Area 5=Вернуться на Путь Айятсбуса, зона 5
Kumi Katayama's Palace=Дворец Куми Катаямы
Door to the Path of Chemdah Closed=Дверь на Путь Чемда закрыта
Path of Chemdah Train Crossing=Переезд на Пути Чемда
Path of Chemdah Train Stopped=Поезд на Пути Чемда остановлен
Return to Path of Chemdah Area 4=Вернуться на Путь Чемда, зона 4
Go to Path of Kaitul=Идти на Путь Кайтула
Return to Path of Chemdah Area 2=Вернуться на Путь Чемда, зона 2
Safe Room (Model)=Безопасная комната (модель)
Exhibition Hall - A15 - Main Unique Shadow (Parameter)=Выставочный зал — А15 — основной уникальный враг (параметр)
Exhibition Hall - A6 - Rare Shadow=Выставочный зал — А6 — редкий враг
Exhibition Hall - B1 - Rare Shadow=Выставочный зал — В1 — редкий враг
Baseball Stadium Photo - No Flash=Фото бейсбольного стадиона — без вспышки
Baseball Stadium Photo - Flash=Фото бейсбольного стадиона — со вспышкой
Exhibition Hall - C1 - Set Shadow=Выставочный зал — С1 — набор врагов
Shutter=Затвор
Home Run 2F - D1 - Rare Shadow=Хоумран 2 этаж — Д1 — редкий враг
C-Rank Security Guard=Охранник C ранга
Exhibition Hall - Left A12 - Rare Shadow=Выставочный зал — слева А12 — редкий враг
First Baseman=Первый базовый игрок
B-Rank Security Guard=Охранник B ранга
Wandering Shadow (Discard)=Бродячая тень (удалено)
Club 1F - Y1 - Front of Safe Room Temporary Wall=Клуб 1 этаж — Y1 — перед временной стеной безопасной комнаты
A-Rank Security Guard=Охранник A ранга
Club 1F - West Y1 - Shadow=Клуб 1 этаж — запад Y1 — тень
Club 1F - West L1 - Unique Shadow (Delete)=Клуб 1 этаж — запад L1 — уникальная тень (удалить)
Club 1F - West L1 - Unique Shadow Display (Delete)=Клуб 1 этаж — запад L1 — отображение уникальной тени (удалить)
Club 1F - North Z2 - Shadow=Клуб 1 этаж — север Z2 — тень
Third Baseman=Третий базовый игрок
Club 1F - North Z3 - Unique Shadow (Delete)=Клуб 1 этаж — север Z3 — уникальная тень (удалить)
Club 1F - West Z5 - Shadow=Клуб 1 этаж — запад Z5 — тень
Club 1F - West Z1 - Unique Shadow (Delete)=Клуб 1 этаж — запад Z1 — уникальная тень (удалить)
Club 1F - West Y2b - Shadow=Клуб 1 этаж — запад Y2b — тень
Club 1F - West Y2b - Unique Shadow (Delete)=Клуб 1 этаж — запад Y2b — уникальная тень (удалить)
Club 1F - East Y4 - Shadow=Клуб 1 этаж — восток Y4 — тень
Club 1F - East Z2 - Unique Shadow (Delete)=Клуб 1 этаж — восток Z2 — уникальная тень (удалить)
Club 1F - East Y2a - Shadow=Клуб 1 этаж — восток Y2a — тень
Club 1F - East Z5 - Shadow=Клуб 1 этаж — восток Z5 — тень
Club 1F - Y3 - Large Face with Mouth Closed=Клуб 1 этаж — Y3 — большое лицо с закрытым ртом
Club 1F - Y3 - Large Face with Mouth Open=Клуб 1 этаж — Y3 — большое лицо с открытым ртом
Frenzied Fiend=Безумный бес
Club 1F - Y3 - Unique Shadow (Delete)=Клуб 1 этаж — Y3 — уникальная тень (удалить)
Club 3F - Y3 - Shadow=Клуб 3 этаж — Y3 — тень
Club 2F - East Y4 - Shadow=Клуб 2 этаж — восток Y4 — тень
Club 2F - East L3 - Shadow=Клуб 2 этаж — восток L3 — тень
Club 2F - East Y6b - Shadow=Клуб 2 этаж — восток Y6b — тень
Club 2F - East Y7 - Unique Shadow (Delete)=Клуб 2 этаж — восток Y7 — уникальная тень (удалить)
Club 2F - East Y2b - Shadow=Клуб 2 этаж — восток Y2b — тень
Club 2F - East Y2b - Unique Shadow (Delete)=Клуб 2 этаж — восток Y2b — уникальная тень (удалить)
Club 2F - West L3 - Main Unique Shadow (Parameter)=Клуб 2 этаж — запад L3 — основной уникальный враг (параметр)
Second Baseman=Второй базовый игрок
Club 2F - West Y6a - Shadow (Parameter)=Клуб 2 этаж — запад Y6a — тень (параметр)
Club 2F - West Y2b - Unique Shadow (Delete)=Клуб 2 этаж — запад Y2b — уникальная тень (удалить)
Club 2F - South Y7 - Unique Shadow (Delete)=Клуб 2 этаж — юг Y7 — уникальная тень (удалить)
Club 2F - South Y2a - Unique Shadow (Delete)=Клуб 2 этаж — юг Y2a — уникальная тень (удалить)
S-Rank Security Guard=Охранник S ранга
Club 3F - North Y7 - Unique Shadow (Delete)=Клуб 3 этаж — север Y7 — уникальная тень (удалить)
Club 3F - Center Z4 - Unique Shadow (Delete)=Клуб 3 этаж — центр Z4 — уникальная тень (удалить)
Club 3F - South Y6b - Unique Shadow (Delete)=Клуб 3 этаж — юг Y6b — уникальная тень (удалить)
Rooftop Obstacle Box=Коробка с препятствиями на крыше
Poster=Плакат
Chapter 3 - Water Treatment Plant - Lower Level - Tval - Shadow01 (Discard)=Глава 3 — Водокачка — нижний уровень — Твал — Тень01 (удалено)
Cognitive Mechanic=Когнитивный механик
Cognitive Operator=Когнитивный оператор
Water Treatment Plant - Lower Level - TR1 - Lufel=Водокачка — нижний уровень — TR1 — Луфель
Water Treatment Plant - Lower Level - TR1 - Motoha=Водокачка — нижний уровень — TR1 — Мотоха
Water Treatment Plant - Lower Level - TR1 - Shun=Водокачка — нижний уровень — TR1 — Шун
Water Treatment Plant - Lower Level - TR1 - Mob Operator NPC - Talking While Standing=Водокачка — нижний уровень — TR1 — NPC оператор толпы — говорит стоя
Water Treatment Plant - Lower Level - TR1 - Mob Operator NPC - Sitting=Водокачка — нижний уровень — TR1 — NPC оператор толпы — сидит
Water Treatment Plant - Lower Level - TR1 - Mob Operator NPC - On Ground=Водокачка — нижний уровень — TR1 — NPC оператор толпы — на земле
Water Treatment Plant - Lower Level - TR1 - Mob Worker NPC - Talking While Standing=Водокачка — нижний уровень — TR1 — NPC рабочий толпы — говорит стоя
Water Treatment Plant - Lower Level - TR1 - Mob Worker NPC - Sitting=Водокачка — нижний уровень — TR1 — NPC рабочий толпы — сидит
Chapter 3 - Water Treatment Plant - Mid-Level - TC2 - Shadow01 (Discard)=Глава 3 — Водокачка — средний уровень — TC2 — Тень01 (удалено)
Water Treatment Plant - Mid-Level - TT1 - Worker NPC - Standing=Водокачка — средний уровень — TT1 — NPC рабочий — стоит
Cognitive Researcher=Когнитивный исследователь
Operator's Shadow=Тень оператора
Cognitive Supervisor=Когнитивный супервайзер
Crouching Worker=Присевший рабочий
Fishing Pond Attendant=Работник рыболовного пруда
Fellow Student=Однокурсник
Gameplay=Игровой процесс
Leather Goods Store=Магазин кожаных изделий
Watch Shop=Магазин часов
Shoe Repair Shop=Ремонт обуви
Audio Shop=Магазин аудиотехники
Umbrella Store=Магазин зонтов
ID Photo Booth=Фотобудка для документов
Souvenir Shop=Магазин сувениров
Bag Store=Магазин сумок
Erika=Эрика
Selfie Machine=Автомат для селфи
Notice=Уведомление
Man in Black=Мужчина в чёрном
Go to the living room=Идти в гостиную
Cook=Готовить
Flower Stand=Цветочный киоск
Garden=Сад
Flowerbed 2=Клумба 2
Kitchen=Кухня
Gardening=Садоводство
Accessway=Проход
Weapon Overclock Dungeon Enemy Lv. 1=Враг подземелья прокачки оружия, уровень 1
Skill Dungeon Enemy Lv. 1=Враг подземелья умений, уровень 1
Phantom Thief Level Up Dungeon Enemy Lv. 1=Враг подземелья повышения уровня Призрачного вора, уровень 1
Persona Level Up Dungeon Enemy Lv. 1=Враг подземелья повышения уровня Персоны, уровень 1
Equipment Enhancement Dungeon Enemy Lv. 1=Враг подземелья улучшения снаряжения, уровень 1
Money Dungeon Enemy Lv. 1=Враг подземелья денег, уровень 1
Revelation Dungeon 2 Enemy Lv. 1=Враг подземелья Откровений 2, уровень 1
Prologue - Return to Shibuya=Пролог — возвращение в Сибуя
Retreat=Отступление
Sahara's Mother's Shadow=Тень матери Сахары
Sahara's Father's Shadow=Тень отца Сахары
