sn	value
CHAT_ITEM_PATTERN	#\{[^#]+?{}[^\}]*?\}
CHAT_NO_MESSAGE	No messages.
CHAT_CHANNEL_NAME_WORLD	The World
CHAT_CHANNEL_NAME_UNION	Alliance
GACHA_NOTICE_CHARACTER	Contracts
GACHA_NOTICE_WEAPON	Supplies
ACTIVITY_CALLBACK_DEFAULT_TEXT	Official Server
PLAYER_DEFAULT_NAME	NagisaÂ¤Kamisiro
PERSONA_EVOLVE_ATTR	HP Boost	Atk Boost	Def Boost
PERSONA_TRAIN_FILTER_TAG_ALL	All
PERSONA_TRAIN_FILTER_TAG_POSITION	Atk	Life	Acc.	Resist	Spec.
CARD_CUSTOM_DISPLAY	Space	Sun	Moon	Star	Sky
UNION_UNIT_ANNOUNCEMENT	No messages from the leader.
CHONGWU_CONTAINER_NAME_BAG	Pet Bag
CHONGWU_CONTAINER_NAME_STORE	Pet Storage
CHONGWU_CONTAINER_NAME_CEMETERY	Pet Cemetery
CHONGWU_CONTAINER_NAME_TEMPORAL	Select All Pets - Bag
TEAM_ENTER_ORDER_TITLE	Forced PVP
EQUIPMENT_FORGE_NORMAL	NoRMaL Build
EQUIPMENT_FORGE_HARD	Enhanced Build
QUESTION_HELP_ANSWER	Your choice
JIEYI_CHAT_GROUP_NAME	Form a close bond
MAIL_SYSTEM_PUBLIC_SEND_NAME	Persona5: The Phantom X Operations Team
PING_EXCEP_KICK_REASON	The server has detected that your network environment is unstable or that you are using third-party tools. Please close the game and log in again.
SOCIAL_THANK	Hi	 I'm new. Nice to meet you.
SOCIAL_HOT_DAY_RESET	0 0 0 * * ?
CONTAINER_NAME_NONE	Container
CONTAINER_NAME_EQUIPMENT	Equipment Column
CONTAINER_NAME_INVENTORY	Bag
CONTAINER_NAME_QUEST	Mission Bag
CONTAINER_NAME_THIEF	Thief Bag
CONTAINER_NAME_TEMPORAL	Temp Bag
CONTAINER_NAME_STORE	Warehouse
CONTAINER_NAME_AMULET	Treasure Bag
CONTAINER_NAME_INGREDIENT	Materials Bag
COLOR_WIHTE	White
COLOR_GREEN	Green
COLOR_BLUE	Blue
COLOR_PURPLE	Purple
COLOR_ORANGE	Orange
COLOR_GOLD	Gold
COLOR_PINK	Pink
COLOR_RED	Red
HINT_TEAM	 Party
FNAME	Last Name
SNAME	First Name
ATTING_FIRST	1st Formation
ATTING_SECOND	2nd Formation
ATTING_THIRD	3rd Formation
ATTING_FOURTH	4th Formation
CHINESE_COMMA		 
TIME_UNITS_DAY	d
TIME_UNITS_HOUR	h
TIME_UNITS_MINUTE	m
PING_EXCEP_SEAL_REASON	Suspected of using third-party tools.
GLOBAL_CROSS_ENTERORDER	Go	 Condor 2!
WEATHER_TIPS_DESCRPTION1	Current Weather: %s
WEATHER_TIPS_DESCRPTION2	Later: %s
WEATHER_TIPS_DESCRPTION3	In %s hours: %s
WEATHER_TIPS_DESCRPTION4	No recent changes.
WEATHER_TIPS_DESCRPTION5	Special Scene
Weather: %s
REWARD_ITEM_DESC	Drop Item:
FIRST_REWARD_ITEM_DESC	First Clear Rewards:
CHALLENGE_BTN_STR	Commence Infiltration
STORY_CHECKPOINT_BTN_STR	View Recollection
ROLE_SCHEME_DEFAULT_NAME1	Equipment Plan 1
ROLE_SCHEME_DEFAULT_NAME2	Equipment Plan 2
ROLE_SCHEME_DEFAULT_NAME3	Equipment Plan 3
ROLE_SCHEME_DEFAULT_NAME4	Equipment Plan 4
ROLE_SCHEME_DEFAULT_NAME5	Equipment Plan 5
ROLE_SCHEME_DEFAULT_NAME6	Equipment Plan 6
ROLE_SCHEME_DEFAULT_NAME7	Equipment Plan 7
ROLE_SCHEME_DEFAULT_NAME8	Equipment Plan 8
ROLE_SCHEME_DEFAULT_NAME9	Equipment Plan 9
ROLE_SCHEME_DEFAULT_NAME10	Equipment Plan 10
CHAPTER_DIFFICULTY_TYPE	NoRMaL	HaRD
WEEK_NAME_1	Monday
WEEK_NAME_2	Tuesday
WEEK_NAME_3	Wednesday
WEEK_NAME_4	Thursday
WEEK_NAME_5	Friday
WEEK_NAME_6	Saturday
WEEK_NAME_7	Sunday
ARRAR_DEFAULTNAME	Party
BATTLEPASS_WEEK_AWARD_TEXT	<color=#FF423F>Log in Tomorrow</color>	<color=#FF423F>Log in Day After Tomorrow</color>	Next Week	Next Week	Next Week	Next Week	Next Week
BLINDBOX_TIME_TEXT	1	2	3	4	5
ACTIVITY_DEFAULT_MAIL_SENDER	Persona5: The Phantom X Operations Team
THIEF_INNATE_WIPE_TEXT	1 More:	Highlight:	Gun Attack:	Melee Attack:
SETTING_STR_LEVEL	Low	Standard	Semi-High	High	Best
SETTING_STR_RESOLUTION	Low	Medium	High
