sn	title	name	Desc	openDesc
1101	Realm of Repression:
Pursuit of Honor	Pursuit of Honor	THIEF LEVEL-UP MATERIALS	Pursuit of Honor
1201	Realm of Repression:
Pursuit of Parts	Pursuit of Parts	WEAPON ENHANCEMENT MATERIALS	Pursuit of Parts
1301	Realm of Repression:
Pursuit of Treasure	Pursuit of Treasure	TONS OF KONPAKU GEMS	Pursuit of Treasure
1401	Realm of Repression:
Pursuit of Persona	Pursuit of Persona	PERSONA ENHANCEMENT MATERIALS	Pursuit of Persona
1500	Realm of Repression:
Alluring Aroma	Alluring Aroma	HIDDEN ABILITY MATERIALS	Wick
1600	Realm of Repression:
Gear Forging	Gear Forging	WEAPON OVERCLOCK MATERIALS	Ore
1700	Realm of Repression:
Enlightenment	Enlightenment	SKILL LEVEL-UP MATERIALS	Awakening
1701	AAAAAA==	AAAAAA==	MINDSCAPE MATERIALS	Awakening
1802	Realm of Repression:
Words of Life	Words of Life	Words of Life	Strife	 Works
1803	Realm of Repression:
Words of Bonds	Words of Bonds	Words of Bonds	Interference	 Oppression
1804	Realm of Repression:
Words of Feuds	Words of Feuds	Words of Feuds	Science	 Virtue
1805	Realm of Repression:
Words of Ruling	Words of Ruling	Words of Ruling	Success	 Sorrow
1809	Realm of Repression:
Words of Nature	Words of Nature	Words of Nature	Dominion	 Reconciliation
1901	Realm of Repression:
Words of Serenity	Words of Serenity	Words of Serenity	Peace	 Worry
2101	Realm of Repression:
Relativity's Labyrinth	Relativity's Labyrinth	Relativity's Labyrinth	Relativity's Labyrinth
3000	Realm of Repression:
Obariyon	Obariyon	Rare Persona	AAAAAA==
3001	Realm of Repression:
Succubus	Succubus	Rare Persona	AAAAAA==
3002	Realm of Repression:
Angel	Angel	Rare Persona	AAAAAA==
3003	Realm of Repression:
Matador	Matador	Rare Persona	AAAAAA==
3004	Realm of Repression:
Kin-Ki	Kin-Ki	Rare Persona	AAAAAA==
3005	Realm of Repression:
Anzu	Anzu	Rare Persona	AAAAAA==
3006	Realm of Repression:
Phoenix	Phoenix	Rare Persona	AAAAAA==
3007	Realm of Repression:
Clotho	Clotho	Rare Persona	AAAAAA==
3008	Realm of Repression:
Fuu-Ki	Fuu-Ki	Rare Persona	AAAAAA==
3009	Realm of Repression:
Black Ooze	Black Ooze	Rare Persona	AAAAAA==
3010	Realm of Repression:
Zouchouten	Zouchouten	Rare Persona	AAAAAA==
3011	Realm of Repression:
Ara Mitama	Ara Mitama	Rare Persona	AAAAAA==
3012	Realm of Repression:
Jatayu	Jatayu	Rare Persona	AAAAAA==
3013	Realm of Repression:
Mothman	Mothman	Rare Persona	AAAAAA==
3014	Realm of Repression:
Kaiwan	Kaiwan	Rare Persona	AAAAAA==
3015	Realm of Repression:
Thoth	Thoth	Rare Persona	AAAAAA==
3016	Realm of Repression:
Mithras	Mithras	Rare Persona	AAAAAA==
3017	Realm of Repression:
Dakini	Dakini	Rare Persona	AAAAAA==
3018	Realm of Repression:
Bugs	Bugs	Rare Persona	AAAAAA==
3019	Realm of Repression:
Pazuzu	Pazuzu	Rare Persona	AAAAAA==
3020	Realm of Repression:
Kumbhanda	Kumbhanda	Rare Persona	AAAAAA==
3021	Realm of Repression:
Hecatoncheires	Hecatoncheires	Rare Persona	AAAAAA==
3022	Realm of Repression:
Kushinada	Kushinada	Rare Persona	AAAAAA==
3023	Realm of Repression:
Girimehkala	Girimehkala	Rare Persona	AAAAAA==
3024	Realm of Repression:
Surt	Surt	Rare Persona	AAAAAA==
3025	Realm of Repression:
Black Rider	Black Rider	Rare Persona	AAAAAA==
3026	Realm of Repression:
Cerberus	Cerberus	Rare Persona	AAAAAA==
3027	Realm of Repression:
Raja Naga	Raja Naga	Rare Persona	AAAAAA==
3028	Realm of Repression:
Barong	Barong	Rare Persona	AAAAAA==
3029	Realm of Repression:
Quetzalcoatl	Quetzalcoatl	Rare Persona	AAAAAA==
3030	Realm of Repression:
Nebiros	Nebiros	Rare Persona	AAAAAA==
3031	Realm of Repression:
Oberon	Oberon	Rare Persona	AAAAAA==
3032	Realm of Repression:
Dionysus	Dionysus	Rare Persona	AAAAAA==
3033	Realm of Repression:
Jack-o'-Lantern	Jack-o'-Lantern	Rare Persona	AAAAAA==
3034	Realm of Repression:
Bicorn	Bicorn	Rare Persona	AAAAAA==
3035	Realm of Repression:
Hua Po	Hua Po	Rare Persona	AAAAAA==
3036	Realm of Repression:
Suzaku	Suzaku	Rare Persona	AAAAAA==
3037	Realm of Repression:
Kodama	Kodama	Rare Persona	AAAAAA==
3038	Realm of Repression:
Orobas	Orobas	Rare Persona	AAAAAA==
