sn	title	text
9851	Genbu I	1. Genbu gains Black Tortoiseshell stacks equal to its <color=#FF423F>Down Points</color>	 increasing its Defense and damage reduction.
2. When Genbu is hit by an attack other than its weakness or a critical	 it gains 1 <color=#FF423F>Down Point</color> and 1 Black Tortoiseshell stack.
3. At the start of its action	 if Genbu has 8 Black Tortoiseshell stacks	 it will activate Genbu's Rage and deal heavy damage to all Phantom Thieves.
9852	Intel	Error: tnxotb-[InstTutorials_text_9852]
10000	Unique Shadow Abilities	Shadows gain the following abilities as turns progress.
Starting on turn 3	 Shadows gain 1 stack of <color=#FF423F>Berserk</color> every turn.
Starting on turn 5	 Shadows gain 2 stacks of <color=#FF423F>Berserk</color> every turn.
Berserk: Damage increases by 10%. Stacks up to 20 times.
201211	Unique Shadow Abilities	1. At the start of battle	 Genbu will gain <color=#FF423F>Black Tortoiseshell</color> stacks equal to its <color=#FF423F>Down Points</color>	 and its Defense and damage reduction will increase with each stack.
2. When Genbu is hit by an attack other than its weakness or a critical	 it will gain 1 <color=#FF423F>Down Point</color> and <color=#FF423F>Black Tortoiseshell</color> stack.
When hit by its weakness or a critical	 it will lose 1 <color=#FF423F>Black Tortoiseshell</color> stack.
When Genbu is knocked down	 it becomes unable to act for 2 turns	 and cannot recover Down Points or use skills.
201212	Unique Shadow Abilities	3. At the start of its action	 Genbu may activate <color=#FF423F>Genbu's Rage</color> and deal heavy Ice damage to all Phantom Thieves.
Damage increases based on the number of <color=#FF423F>Black Tortoiseshell</color> stacks.
201221	Unique Shadow Abilities	1. At the start of battle	 Genbu will gain <color=#FF423F>Black Tortoiseshell</color> stacks equal to its <color=#FF423F>Down Points</color>	 and its Defense and damage reduction will increase with each stack.
2. When Genbu is hit by an attack other than its weakness or a critical	 it will gain 1 <color=#FF423F>Down Point</color> and <color=#FF423F>Black Tortoiseshell</color> stack.
When hit by its weakness or a critical	 it will lose 1 <color=#FF423F>Black Tortoiseshell</color> stack.
When Genbu is knocked down	 it becomes unable to act for 2 turns	 and cannot recover Down Points or use skills.
201222	Unique Shadow Abilities	3. At the start of its action	 if Genbu has 8 Black Tortoiseshell stacks	 it will activate <color=#FF423F>Genbu's Rage</color> and deal heavy damage to all Phantom Thieves.
4. The effect of <color=#FF423F>Black Tortoiseshell</color> applies to other Shadows as well.
201251	Unique Shadow Abilities	1. At the start of battle	 Genbu will gain <color=#FF423F>Black Tortoiseshell</color> stacks equal to its <color=#FF423F>Down Points</color>	 and its Defense and damage reduction will increase with each stack.
2. When Genbu is hit by an attack other than its weakness or a critical	 it will gain 1 <color=#FF423F>Down Point</color> and <color=#FF423F>Black Tortoiseshell</color> stack.
When hit by its weakness or a critical	 it will lose 1 <color=#FF423F>Black Tortoiseshell</color> stack.
When Genbu is knocked down	 it becomes unable to act for 2 turns	 and cannot recover Down Points or use skills.
201252	Unique Shadow Abilities	3. At the start of its action	 if Genbu has 8 Black Tortoiseshell stacks	 it will activate <color=#FF423F>Genbu's Rage</color> and deal heavy damage to all Phantom Thieves.
4. Apsaras will periodically grant Elec Wall to Genbu.
202171	Unique Shadow Abilities	1. When Suzaku attacks	 it inflicts 1 stack of <color=#FF423F>Nuclear Heat</color> to the target.
2. When the number of Nuclear Heat stacks reaches 6	 the Phantom Thief takes heavy damage.
3. For each stack of Nuclear Heat	 the Phantom Thief's Attack decreases.
202172	Unique Shadow Abilities	4. When Apsaras attacks	 it inflicts <color=#FF423F>Nuclear Heat</color> on the target.
5. When Hua Po attacks	 it removes 2 stacks of Nuclear Heat from itself.
202191	Unique Shadow Abilities	1. When Suzaku attacks	 it inflicts 1 stack of <color=#FF423F>Nuclear Heat</color> to the target.
2. When the number of Nuclear Heat stacks reaches 6	 the Phantom Thief takes heavy damage.
202192	Unique Shadow Abilities	3. At the start of battle	 Suzaku will select 1 Andras.
 When the selected Andras attacks	 the target is inflicted with 2 stacks of <color=#FF423F>Nuclear Heat</color>.
4. When the selected Andras is defeated	 all Phantom Thieves have their Nuclear Heat removed.
202251	Unique Shadow Abilities	1. When Suzaku attacks	 it inflicts 1 stack of <color=#FF423F>Nuclear Heat</color> to the target.
2. When the number of Nuclear Heat stacks reaches 6	 the target takes heavy damage.
3. When Suzaku is attacked	 it inflicts 1 stack of Nuclear Heat on the attacker.
4. Succubus will grant a barrier to Suzaku that can negate damage once.
202291	Unique Shadow Abilities	1. When Suzaku attacks	 it inflicts 1 stack of <color=#FF423F>Nuclear Heat</color> on the target.
2. When a Phantom Thief reaches 6 stacks of Nuclear Heat	 they take heavy damage.
3. When Suzaku attacks a Phantom Thief with less than 50% HP	 it inflicts 2 stacks of Nuclear Heat on the target.
202211	Unique Shadow Abilities	1. Archangel will make Phantom Thieves <color=#FF423F>Dizzy</color> for 2 turns.
At the start of the next turn	 if any Phantom Thieves are Dizzy	 Archangel will use <color=#FF423F>Lunge</color> to deal heavy damage.
2. Archangel will make Phantom Thieves Dizzy based on their turn order.
202212	Unique Shadow Abilities	3. If Archangel's <color=#FF423F>Shield</color> is broken	 all Phantom Thieves will recover from <color=#FF423F>Dizzy</color>.
202231	Unique Shadow Abilities	1. Archangel will make Phantom Thieves <color=#FF423F>Dizzy</color> for 2 turns.
At the start of the next turn	 if any Phantom Thieves are Dizzy	 Archangel will use <color=#FF423F>Lunge</color> to deal heavy damage.
202271	Unique Shadow Abilities	1. Archangel will make Phantom Thieves <color=#FF423F>Dizzy</color> for 2 turns.
At the start of the next turn	 if any Phantom Thieves are Dizzy	 Archangel will use <color=#FF423F>Lunge</color> to deal heavy damage.
2. When Archangel is attacked	 it will inflict 1 <color=#FF423F>Sin</color> on the attacker.
The Phantom Thief with the most Sins will become Dizzy.
202272	Unique Shadow Abilities	3. Archangel deals more damage based on the number of <color=#FF423F>Sin</color> stacks present.
4. Attacking Apsaras will remove 1 Sin.
202311	Unique Shadow Abilities	1. Archangel will make Phantom Thieves <color=#FF423F>Dizzy</color> for 2 turns.
At the start of the next turn	 if any Phantom Thieves are Dizzy	 Archangel will use <color=#FF423F>Lunge</color> to deal heavy damage.
202312	Unique Shadow Abilities	2. The Shadow has two stances	 <color=#FF423F>Attack Position</color> and <color=#FF423F>Defense Position</color>.
Attack Position increases Attack by 10% each turn	 and resets when the stance is changed.
Defense Position increases Defense by 10% each turn	 and resets when the stance is changed.
202313	Unique Shadow Abilities	3. At the start of battle	 Archangel selects 1 Phantom Thief	 and changes stances each time it is attacked by that Thief.
The selected Thief cannot become <color=#FF423F>Dizzy</color>.
202314	Unique Shadow Abilities	4. When in Attack Position	 Archangel will use <color=#FF423F>Lunge</color> against all Phantom Thieves.
When in Defense Position	 Archangel will cause attackers to become <color=#FF423F>Dizzy</color>.
203711	Unique Shadow Abilities	1. At the start of battle	 Eligor activates <color=#FF423F>Royal Domain</color>.
Royal Domain changes all the user's affinities to <color=#FF423F>Null</color>.
2. On Eligor's turn	 it summons 1 Berith and activates <color=#FF423F>Royal Aid</color>.
Royal Aid is granted to 1 Berith	 heals 50% of its max HP	 negates 50% of damage taken for 1 turn	 and inflicts <color=#FF423F>Taunt</color> on all Phantom Thieves.
203712	Unique Shadow Abilities	3. If a Berith is defeated	 Eligor loses a certain amount of HP.
4. If the number of Beriths increases	 Eligor activates <color=#FF423F>Royal Conquest</color>	 dealing heavy Physical damage to all Phantom Thieves.
203731	Unique Shadow Abilities	1. On Eligor's action	 it can summon 1 Berith and activate <color=#FF423F>Royal Favor</color>.
Royal Favor is granted to 1 Berith	 decreasing its Defense but greatly increasing its damage.
2. When Eligor dies	 all Beriths gain Royal Favor.
203732	Unique Shadow Abilities	3. If the number of Beriths increases	 Eligor activates <color=#FF423F>Royal Conquest</color>	 dealing heavy Physical damage to all Phantom Thieves.
203771	Unique Shadow Abilities	1. On Eligor's action	 it can summon 1 Berith and activate <color=#FF423F>Royal Authority</color>.
Royal Authority grants <color=#FF423F>Royal Fealty</color> to 1 Berith.
When Eligor takes damage	 this Berith will take damage instead.
203772	Unique Shadow Abilities	2. When a Berith is defeated	 Eligor gains 1 <color=#FF423F>Royal Sorrow</color> stack.
When it has 3 stacks	 it enters the <color=#FF423F>Royal Wrath</color> state.
3. When Royal Wrath is active	 Eligor can activate Royal Conquest	 dealing heavy Physical damage to all Phantom Thieves.
203751	Unique Shadow Abilities	1. On Eligor's action	 it summons 1 Berith and activates <color=#FF423F>Royal Decree</color>.
Royal Decree: Select 1 Phantom Thief	 and Berith focuses attacks on that Thief for the next turn.
2. When Eligor has <color=#FF423F>Royal Majesty</color> and attacks a Phantom Thief with a skill	 the damage taken by that Thief is permanently increased.
203791	Unique Shadow Abilities	1. At the start of battle	 Eligor activates <color=#FF423F>Royal Domain</color>.
While Royal Domain is active	 all Shadows have increased Attack and Defense.
2. On Eligor's action	 it can activate <color=#FF423F>Royal Healing</color> to restore HP to all Shadows.
203811	Unique Shadow Abilities	When Nue acts	 Nue and other Shadows will gain one of the following random effects for 1 turn:
<color=#FF423F>Monkey Mask</color>: At the end of the turn	 heals a certain amount of HP. Heals any elemental ailments.
<color=#FF423F>Tanuki Form</color>: Gains an 80% dodge chance. Heals any spiritual ailments.
203812	Unique Shadow Abilities	<color=#FF423F>Tiger Claws</color>: Greatly increases damage.
<color=#FF423F>Snake Tail</color>: Inflicts Poison when dealing damage.
203851	Unique Shadow Abilities	1. At the start of battle	 Nue gains all 4 of the following effects:
<color=#FF423F>Monkey Mask</color>: At the end of the turn	 heals a certain amount of HP.
<color=#FF423F>Tanuki Form</color>: Gains an 80% dodge chance.
203852	Unique Shadow Abilities	<color=#FF423F>Tiger Claws</color>: Greatly increases damage.
<color=#FF423F>Snake Tail</color>: Inflicts Poison when dealing damage.
203853	Unique Shadow Abilities	2. When the Monkey Mask	 Tanuki Form	 Tiger Claws	 or Snake Tail Shadows are defeated	 the corresponding effects will be removed from Nue.
3. When all 4 effects have been removed	 Nue will become Weakened.
203831	Unique Shadow Abilities	When Nue acts	 Nue will gain 1 of the following random effects for 3 turns:
<color=#FF423F>Monkey Mask</color>: At the end of the turn	 heals a certain amount of HP. Heals any elemental ailments.
<color=#FF423F>Tanuki Form</color>: Gains an 80% dodge chance. Heals any spiritual ailments.
203832	Unique Shadow Abilities	<color=#FF423F>Tiger Claws</color>: Greatly increases damage.
<color=#FF423F>Snake Tail</color>: Inflicts Poison when dealing damage.
<color=#FF423F>Nue's Power</color>: Greatly increases Attack and Defense.
203871	Unique Shadow Abilities	1. Every 2 turns	 Yaksini will activate <color=#FF423F>True Wage War</color>.
True Wage War has a high chance to <color=#FF423F>Enrage</color> all Phantom Thieves.
Rage: Causes target to use <color=#FF423F>normal attacks</color> uncontrollably.
Attack is greatly increased	 and Defense is greatly decreased.
203872	Unique Shadow Abilities	2. When Yaksini is hit by a normal attack	 it gains 1 Yaksha	 increasing its Attack for each stack.
203891	Unique Shadow Abilities	1. Every 2 turns	 Yaksini will become <color=#FF423F>Enraged</color>	 and randomly target 1 Phantom Thief	 dealing heavy Physical damage on the next turn.
Rage: Causes target to use <color=#FF423F>normal attacks</color> uncontrollably.
Attack is greatly increased	 and Defense is greatly decreased.
203892	Unique Shadow Abilities	2. When Yaksini is hit by a normal attack	 it gains 1 Yaksha	
increasing its Attack for each stack.
203911	Unique Shadow Abilities	1. When Yaksini's HP falls below 50% for the first time	 it will activate <color=#FF423F>True Wage War</color>	 and enter Counterattack Stance for 1 turn.
True Wage War has a high chance to <color=#FF423F>Enrage</color> all Phantom Thieves.
Rage: Causes target to use <color=#FF423F>normal attacks</color> uncontrollably.
Attack is greatly increased	 and Defense is greatly decreased.
203912	Unique Shadow Abilities	<color=#FF423F>Counterattack Stance</color>: When Yaksini is hit by a normal attack	 it will counterattack and deal single-target Physical damage to the attacker.
2. When Yaksini hit by a normal attack	 it gains 1 Yaksha	 increasing its Attack for each stack.
203931	Unique Shadow Abilities	1. Starting on turn 2	 Yaksini will activate <color=#FF423F>True Wage War</color> multiple times.
True Wage War has a high chance to <color=#FF423F>Enrage</color> all Phantom Thieves.
Rage: Causes target to use <color=#FF423F>normal attacks</color> uncontrollably.
Attack is greatly increased	 and Defense is greatly decreased.
203932	Unique Shadow Abilities	2. The damage Inugami receives from normal attacks is greatly decreased.
When Inugami is defeated	 all Phantom Thieves gain <color=#FF423F>Inugami's Blessing</color>	 significantly increasing ailment resistance for 2 turns.
3. When Yaksini is hit by a normal attack	 it gains 1 Yaksha	 increasing its Attack for each stack.
211511	Unique Shadow Abilities	1. Oni always has <color=#FF423F>Absolute Counter</color>.
Whenever it takes damage	 it will counterattack	 dealing single-target Physical damage to the attacker.
2. Whenever Oni counterattacks	 a count is added	 and when the count reaches 4	 it activates <color=#FF423F>Hyakki Yagyo</color>	 dealing heavy damage to all Phantom Thieves.
211512	Unique Shadow Abilities	3. On each of Oni's turns	 1 Phantom Thief gains <color=#72C5FF>Oni Slayer</color>. A Phantom Thief in this state will not activate Oni's Absolute Counter for 1 turn.
4. When Obariyon is defeated	 all Phantom Thieves gain <color=#72C5FF>Oni Slayer</color> for 1 turn.
211531	Unique Shadow Abilities	1. Every 2 turns	 Oni will gain <color=#FF423F>Absolute Counter</color> for 1 turn.
Whenever it takes damage	 it will counterattack	 dealing single-target Physical damage to the attacker.
2. Whenever Oni counterattacks	 a count is added	 and when the count reaches 4	 it activates <color=#FF423F>Hyakki Yagyo</color>	 dealing heavy damage to all Phantom Thieves.
211551	Unique Shadow Abilities	1. Each turn	 Oni will alternate between <color=#FF423F>Physical Counter</color> and <color=#FF423F>Magic Counter</color>.
Whenever it takes damage of the corresponding attribute	 it will counterattack	 dealing single-target Physical damage to the attacker.
2. Whenever Oni counterattacks	 a count is added	 and when the count reaches 4	 it activates <color=#FF423F>Hyakki Yagyo</color>	 dealing heavy damage to all Phantom Thieves.
211571	Unique Shadow Abilities	1. Shiki-Ouji's initial affinity to each attribute is Normal.
2. Each time it receives damage from an attribute	 Shiki-Ouji's affinity to that attribute permanently becomes <color=#FF423F>Null</color>.
Each time Shiki-Ouji's affinity changes	 as a <color=#FF423F>Side Effect</color>	 its Damage Taken is also permanently increased by 30%.
211572	Unique Shadow Abilities	3. When Koropokguru is defeated	 all of Shiki-Ouji's affinities are reset	 and it loses all Side Effects.
211591	Unique Shadow Abilities	1. Shiki-Ouji starts with all affinities as Normal.
Each turn	 Shiki-Ouji randomly changes 5 affinities to <color=#FF423F>Null</color> for 1 turn.
2. At the end of Shiki-Ouji's turn	 it gains 3 <color=#FF423F>Woe</color> stacks.
Each stack increases its damage by 50%.
Each time Shiki-Ouji takes damage	 it loses 1 stack.
211592	Unique Shadow Abilities	3. If Shiki-Ouji has Woe at the beginning of its turn	 it changes to <color=#FF423F>Disaster</color>.
When it has 3 stacks of Disaster	 it automatically activates <color=#FF423F>Karma</color>	 dealing heavy damage to all Phantom Thieves.
211611	Unique Shadow Abilities	1. Shiki-Ouji's initial affinity to each attribute is <color=#FF423F>Null</color>.
2. Each time Mokoi receives damage	 Shiki-Ouji's affinity to a random attribute becomes <color=#FF423F>Normal</color>.
Shiki-Ouji can have a maximum of 1 affinity set to Normal.
211612	Unique Shadow Abilities	3. Each time Shiki-Ouji receives damage from an attribute	 its affinity to that attribute permanently becomes Null.
Each time Shiki-Ouji's affinity changes	 as a <color=#FF423F>Side Effect</color>	 its damage taken is also permanently increased by 30%.
410111	Special Effect	When a Shadow is defeated	 the damage dealt by all Phantom Thieves increases by 25%.
Stacks up to 2 times.
420111	Special Effect	1. Due to the erosion of Mementos	 after any Phantom Thief's action	 all Phantom Thieves lose 5% HP.
2. After all Phantom Thieves receive healing	 their damage increases by 25%. Lasts 2 turns. Stacks up to 2 times.
430111	Special Effect	After a Shadow takes damage	 damage dealt by all Phantom Thieves increases by 5%.
Stacks up to 10 times.
440111	Special Effect	Increases the damage of all Phantom Thieves' <color=#FF423F>Fire</color> attacks by 50%.
441111	Special Effect	Increases the damage of all Phantom Thieves' <color=#FF423F>Ice</color> attacks by 50%.
442111	Special Effect	Increases the damage of all Phantom Thieves' <color=#FF423F>Electric</color> attacks by 50%.
443111	Special Effect	Increases the damage of all Phantom Thieves' <color=#FF423F>Wind</color> attacks by 50%.
444111	Special Effect	Increases the damage of all Phantom Thieves' <color=#FF423F>Psychokinesis</color> attacks by 50%.
445111	Special Effect	Increases the damage of all Phantom Thieves' <color=#FF423F>Nuclear</color> attacks by 50%.
446111	Special Effect	Increases the damage of all Phantom Thieves' <color=#FF423F>Bless</color> attacks by 50%.
447111	Special Effect	Increases the damage of all Phantom Thieves' <color=#FF423F>Curse</color> attacks by 50%.
501101	Special Effect	1. Cerberus will summon minions during the battle.
When a minion is defeated	 Cerberus takes Almighty damage.
2. When Cerberus has taken a certain amount of damage	 it moves to the next phase	 and all Phantom Thieves restore SP.
501111	Special Effect	Each time a certain number of turns pass	 Melchizedek changes its affinities	 decreasing its damage taken.
It also summons a servant. When the servant is defeated	 the Phantom Thieves' critical rate and critical damage are increased.
502101	Special Effect	1. At the start of battle	 Zaou-Gongen gains 15 Vajra Shield stacks. Each stack decreases damage taken by 5%.
2. When Zaou-Gongen takes damage from a skill or Resonance	 it loses 1 Vajra Shield stack.
3. When Zaou-Gongen loses all Vajra Shield stacks	 all Phantom Thieves gain Demon Power	 increasing their damage.
502111	Special Effect	1. At the start of battle	 Oberon and Titania each gain 5 Fairy Power	 decreasing damage taken by 4% per stack.
2. Each time Oberon or Titania is defeated	 the other will spend 1 Fairy Power to summon them again.
3. When their Fairy Power is depleted	 Oberon and Titania will be weakened	 greatly increasing their damage taken.
Lasts for 2 turns	 after which they regain 5 Fairy Power.
503101	Special Effect	1. Power will summon servants. When a servant is defeated	 Power takes Almighty damage based on the servant's max HP.
2. Power will restore all Phantom Thieves' SP each turn	 but also uses Angel's Bindings on the Phantom Thief with the highest Attack	 greatly decreasing their damage.
503111	Special Effect	1. At the start of battle	 Zaou-Gongen gains 15 Vajra Shield stacks. Each stack decreases damage taken by 5%.
2. When Zaou-Gongen takes damage from a skill or Resonance	 it loses 1 Vajra Shield stack.
3. When Zaou-Gongen loses all Vajra Shield stacks	 all Phantom Thieves gain Demon Power	 increasing their damage.
504011	Special Effect	Each turn	 the Four Heavenly Kings will focus their Death Stare on 1 Phantom Thief.
They will prioritize attacking the Phantom Thief under the Death Stare.
By using Taunt skills	 a Phantom Thief can transfer the Death Stare to themselves.
504111	Special Effect	Each turn	 Asura inflicts Vajra Curse on the 2 Phantom Thieves with the highest Attack	 greatly decreasing their damage.
505101	Special Effect	1. Each turn	 Zaou-Gongen gains 15 Vajra Shield stacks. Each stack decreases damage taken by 5%.
2. When Zaou-Gongen takes damage from a skill or additional effect	 it loses 1 stack of Vajra Shield.
3. When Zaou-Gongen loses all stacks of Vajra Shield	 all Phantom Thieves gain Demon Power	 increasing their damage.
506101	Special Effect	1. At the start of battle	 Seiryu gains 2 Azure Scales stacks	 and gains 1 more stack every turn.
Each stack decreases damage taken by 15%.
2. When Seiryu takes weakness damage	 it loses 1 Azure Scales stack.
3. When Seiryu loses all Azure Scales stacks	 all Phantom Thieves gain Azure Power	 increasing their damage.
508111	Special Effect	1. Sraosha will summon servants during the battle.
When a servant is defeated	 Sraosha takes Almighty damage based on the servant's max HP.
2. Sraosha will restore all Phantom Thieves' SP each turn	 but also uses Debilitate on the Phantom Thief with the highest Attack	 greatly decreasing their damage.
3. When a servant loses a Down Point	 all Phantom Thieves' damage is increased by 15%. Lasts for 1 turn.
509101	Special Effect	1. Baphomet will summon minions during the battle.
When a minion is defeated	 Baphomet takes Almighty damage based on the minion's max HP.
2. Baphomet will restore all Phantom Thieves' SP each turn	 but also inflicts Devilish Hex on the Phantom Thief with the highest Attack	 greatly decreasing their damage.
3. When a minion is knocked down	 all Phantom Thieves' damage is increased by 15%. Lasts for 1 turn.
510101	Special Effect	1. At the start of battle	 Asura gains 2 Vajra Armor stacks and restores 1 stack each turn.
Each stack reduces damage taken by 15%.
2. When Asura takes damage from its weakness	 it loses 1 Vajra Armor stack.
3. When Asura loses all Vajra Armor stacks	 all Phantom Thieves gain Demon Subjugation	 increasing their damage.
511101	Special Effect	1. Cu Chulainn gains 2 Runic Protection stacks each turn. Each stack decreases damage taken by 15%.
2. When Cu Chulainn takes damage from its weakness	 it loses 1 Runic Protection stack.
3. When Cu Chulainn loses all Runic Protection stacks	 all Phantom Thieves gain Runic Strength	 increasing their damage.
4. Cu Chulainn will restore all Phantom Thieves' SP each turn	 but also inflicts Runic Curse on the Phantom Thief with the highest Attack	 greatly decreasing their damage.
512101	Special Effect	1. Each turn	 Titania gains 2 Fairy Power.
2. Titania loses 1 Fairy Power each time she takes a Physical attack.
3. Before the start of her turn	 Titania spends all Fairy Power to activate Fairy Curse	 decreasing all Phantom Thieves' damage by 15% for each Fairy Power spent.
512111	Special Effect	1. Baphomet will summon minions during the battle.
When a minion is defeated	 Baphomet takes Almighty damage based on the minion's max HP.
2. Baphomet will restore all Phantom Thieves' SP each turn	 but also inflicts Devilish Hex on the Phantom Thief with the highest Attack	 greatly decreasing their damage.
513101	Special Effect	1. At the start of battle	 all four angels are affected by Demonic Curse	 changing all affinities to Weak. Lasts for 1 turn.
2. Raphael will restore all Phantom Thieves' SP every turn	 but also inflicts Angelic Binding on the Phantom Thief with the highest Attack	 greatly decreasing their damage.
514101	Special Effect	Each turn the Four Heavenly Kings will focus their Death Stare on 1 random Phantom Thief.
They will prioritize attacking the Phantom Thief under the Death Stare.
515101	Special Effect	Quetzalcoatl forms a <color=#FF423F>Soul Link</color> with all Yurlungurs.
Soul Link: Distributes all damage received between all Shadows who share this condition	 based on the percentage of their current HP.
517101	Special Effect	1. Melchizedek gains 6 stacks of Divine Protection each turn	 and each stack of Divine Protection decreases damage taken by 5%.
2. Melchizedek loses 1 Divine Protection each time it takes damage from a skill or Resonance.
3. When Melchizedek has lost all Divine Protection	 all Phantom Thieves receive Divine Protection	 and their damage is increased.
701011	The Velvet Trials	At the start of its turn	 Suzaku will select 1 Phantom Thief and decrease their Defense. On the next turn	 it will attack the selected Phantom Thief.
<color=#FF423F>Guarding</color> is recommended.
701021	The Velvet Trials	1. Oni will use the <color=#FF423F>Taunt</color> skill on all Phantom Thieves.
2. If all Shadows besides Oni are defeated	 Oni will become Weakened.
701031	The Velvet Trials	If Lamia survives for more than 3 turns	 it will use a powerful multi-target attack skill.
701041	The Velvet Trials	After being defeated	 Shadows take greatly increased damage.
701051	The Velvet Trials	1. When Eligor's HP falls below 70% or 30%	 it summons 1 minion.
While the minion is present	 Eligor's damage increases and its damage taken decreases.
2. The minion will attack the Phantom Thief with the lowest percentage of remaining HP.
701061	The Velvet Trials	1. At the end of Zouchouten's turn	 it selects a random Phantom Thief to attack on the next turn.
2. While Ippon-Datara is present	 Zouchouten's Attack is increased.
3. While High Pixie is present	 Zouchouten's Defense is increased.
701062	The Velvet Trials	4. While Succubus is present	 Zouchouten's critical rate is increased.
5. When all Shadows besides Zouchouten are defeated	 Zouchouten will activate a special skill after 3 turns.
702011	The Velvet Trials	1. Phantom Thieves affected by Nue's <color=#FF423F>Plague Curse</color> will be unable to heal starting from the <color=#FF423F>next turn</color>. Lasts for 2 turns.
2. Onmoraki will only attack Phantom Thieves who are unable to heal.
702021	The Velvet Trials	1. Sui-Ki can only take <color=#FF423F>Physical</color> and <color=#FF423F>Gun</color> damage.
After being knocked down	 all affinities become Weak.
2. When Mothman is defeated	 all Phantom Thieves' critical rate is greatly increased. Lasts for 2 turns.
702031	The Velvet Trials	1. When Shiki-Ouji's HP is reduced to 0	 it will not be defeated	 but enters a <color=#FF423F>False Death</color> state.
After 2 turns	 it will recover some HP and increase the Attack of all Shadows.
2. When all Shiki-Ouji are in the False Death state	 you win the battle.
3. At the start of Shiki-Ouji's turn	 it has a set chance to grant itself a <color=#FF423F>barrier</color> that can nullify damage once.
702041	The Velvet Trials	Shadows gain the following abilities: After taking damage	 all other Shadows take decreased damage. Stacks up to 5 times.
When defeated	 the decreased damage effect on all other Shadows is removed.
702051	The Velvet Trials	Shadows gain the following abilities: At the start of the turn	 gain a barrier that can nullify damage once.
702061	The Velvet Trials	1. Every 3 turns	 Anubis will curse 1 Phantom Thief	 dealing 50% of their max HP as damage and knocking them down.
The curse is lifted when the cursed Phantom Thief's HP is fully healed.
2. If the curse is not lifted within 2 turns	 the Phantom Thief will be KO'd.
702071	The Velvet Trials	1. When Unicorn is affected by a debuff	 its Attack and Defense are permanently decreased. This effect can stack.
2. When Unicorn uses Charge and is affected by a debuff while Charging	 it immediately counterattacks with a powerful skill and removes the debuff.
702072	The Velvet Trials	1. Leanan Sidhe will first remove its own debuffs	 and then remove Unicorn's debuffs.
If neither of them have any debuffs	 it uses an attack skill.
702081	The Velvet Trials	1. At the start of the battle	 Okuninushi becomes invincible and does not attack	 instead summoning 4 random enemies.
2. Nigi Mitama: After 3 turns	 it unleashes a powerful area attack skill.
3. Kushi Mitama: It has low HP but high attack power.
It targets the Phantom Thief with the lowest HP and attacks with an insta-kill skill.
702082	The Velvet Trials	4. Saki Mitama: It has high HP and Defense	 but its Defense decreases each turn.
702083	The Velvet Trials	5. When the other Shadows are defeated	 Okuninushi will be Weakened	 and can be attacked.
Lasts for 2 turns.
6. When Okuninushi's HP falls below 66%	 it becomes invincible again and randomly summons 4 more enemies.
7. When the Shadows are defeated	 Okuninushi becomes Weakened again.
702084	The Velvet Trials	8. When Okuninushi's HP falls below 33%	 it will begin to attack.
702091	The Velvet Trials	1. At the start of battle	 Belphegor randomly selects 1 Phantom Thief	 greatly increasing their max HP	 but reducing their remaining HP to 5%.
2. The higher the HP percentage of the Phantom Thief	 the more damage will be dealt.
3. Belphegor will summon Mokoi	 who will flee after 1 turn.
If Mokoi is defeated	 all Phantom Thieves restore 30% HP.
702101	The Velvet Trials	1. Due to a mysterious power	 all Phantom Thieves will be <color=#FF423F>unable to heal</color> during this Trial.
2. Attacking Kodama will greatly increase the Attack of all Phantom Thieves. Lasts for 2 turns.
3. Attacking Sudama will add <color=#FF423F>Life Drain</color> to all Phantom Thieves' attacks. Lasts for 2 turns.
4. Defeat Arahabaki to win the battle.
703011	The Velvet Trials	1. All of Black Ooze's affinities start as <color=#FF423F>Weak</color>.
2. After taking damage	 Black Ooze's affinity to that attack's attribute becomes <color=#FF423F>Repel</color>. Lasts for 2 turns.
703021	The Velvet Trials	1. At the end of each turn	 Suzaku raises the Heat level.
If the Heat is high at the start of the turn	 Suzaku deals heavy Nuclear damage to all Phantom Thieves.
2. If Jack Frost is defeated	 <color=#FF423F>the Heat level decreases significantly</color>.
703051	The Velvet Trials	The Archangels switch between <color=#FF423F>Discipline</color> and <color=#FF423F>Fervor</color> modes for both Phantom Thieves and Shadows.
Discipline: Damage taken is greatly decreased	 and healing is greatly increased.
Fervor: Damage both taken and dealt is greatly increased.
703091	The Velvet Trials	1. When Arahabaki takes damage	 it will record the attribute of the damage taken.
2. When Arahabaki takes damage of the <color=#FF423F>same attribute</color> it previously recorded	 its <color=#FF423F>damage taken</color> increases. This effect can stack.
3. When Arahabaki takes damage of a different attribute than the one it recorded	 the increased damage taken effect is removed	 and Arahabaki's damage increases.
703101	The Velvet Trials	1. When Take-Minakata takes damage	 it will record the attribute of the damage taken.
2. When Take-Minakata takes damage of a <color=#FF423F>different attribute</color> than what it previously recorded	 its <color=#FF423F>damage taken</color> increases.
This effect can stack.
3. When Take-Minakata takes damage of the same attribute as the one it recorded	 the increased damage taken effect is removed	 and Take-Minakata's damage increases.
703111	The Velvet Trials	Defeating Shadows will grant the following effects:
1. Jack-o'-Lantern: When defeated	 the attacking Phantom Thief's Attack decreases by 30%.
2. Jack Frost: When defeated	 the attacking Phantom Thief's Attack increases by 30%.
3. King Frost: When defeated	 the attacking Phantom Thief's Attack increases by 100%.
703031	The Velvet Trials	1. When Shadows damage a Phantom Thief	 their <color=#FF423F>SP</color> will decrease.
2. Every 2 turns	 Setanta summons 1 Sudama.
When Sudama is defeated	 all Phantom Thieves restore SP.
703071	The Velvet Trials	1. The first damage Girimehkala takes is greatly decreased	 but <color=#FF423F>the next damage taken is greatly increased</color>. When Girimehkala acts	 this effect is reset.
2. Girimehkala summons 1 Sudama every turn.
When Sudama is defeated	 Girimehkala takes 5 hits of Almighty damage.
703081	The Velvet Trials	1. The first damage Oberon and Titania take is greatly increased	 but <color=#FF423F>the next damage taken is greatly decreased</color>.
This effect is reset every 2 turns.
2. When either Oberon or Titania is defeated	 the other will become Sad for 1 turn.
After they recover	 their damage will be significantly increased.
703061	The Velvet Trials	1. Due to a mysterious power	 a random Phantom Thief or Shadow will gain 1 stack of <color=#FF423F>Soul Vessel</color> each turn.
Soul Vessel: Damage and healing effect increase	 but a set amount of HP is lost every turn.
Stacks up to 5 times.
703062	The Velvet Trials	2. When a character with Soul Vessel is defeated	 the attacker <color=#FF423F>takes all of their Soul Vessel stacks</color>.
703121	The Three Fates	1. Clotho uses Moirai Binding to grant a random Phantom Thief the Thread of Fate.
2. Lachesis uses Moirai Spinning to change a Phantom Thief's Thread of Fate to <color=#FF423F>Weave of Fate</color>.
Weave of Fate: Attack increases due to the threads of fate.
703122	The Three Fates	3. At certain times	 Clotho	 Lachesis and Atropos will summon a Spirit of Fate.
Defeating the Spirit of Fate will grant an <color=#FF423F>additional strengthening effect</color> to Phantom Thieves with the Weave of Fate.
703123	The Three Fates	4. At certain times	 Atropos will use <color=#FF423F>Moirai Cutting</color>	 dealing severe damage to Phantom Thieves with the Weave of Fate.
(1) After Atropos has acted 10 times.
(2) After Clotho or Lachesis have been defeated.
(3) After Atropos has been defeated.
703141	Yamata-no-Orochi	1. When Yamata-no-Orochi's HP reaches 0	 it revives with new affinities and skills. It can revive up to 4 times.
703142	Yamata-no-Orochi	2. After reviving 4 times	 Yamata-no-Orochi will begin preparing and summon a Serpent's Tail.
3. When a Serpent's Tail is defeated	 all Phantom Thieves gain <color=#FF423F>Ame-no-Murakumo</color>	 which greatly increases the damage of their next attack.
703143	Yamata-no-Orochi	4. When Yamata-no-Orochi is defeated	 4 Shadows appear.
703131	Hecatoncheires	1. At the start of the battle	 Hecatoncheires has 100 <color=#FF423F>Arms of Protection</color> stacks	 and takes less damage depending on the number of stacks.
When it has Arms of Protection	 it also has <color=#FF423F>Arms of Defense</color>	 reducing final damage by 70%.
703132	Hecatoncheires	2. Hecatoncheires will summon the Avatar of Arms and the Avatar of Gathering.
When the Avatar of Arms is defeated	 it loses 1 Arms of Protection stack. When the Avatar of Gathering is defeated	 it loses 10 Arms of Protection stacks.
For each Arms of Protection stack removed	 all Phantom Thieves gain <color=#FF423F>Arms of Strength</color>.
Arms of Strength: Damage increased based on number of stacks.
703133	Hecatoncheires	3. When Hecatoncheires has 80 or more Arms of Protection stacks	 it becomes <color=#FF423F>invincible</color> and will not attack.
It keeps 4 Avatars of Arms on the field	 and gains 1 <color=#FF423F>Arms of Might</color> stack every turn.
Arms of Might: Damage increased based on number of stacks.
4. When Hecatoncheires has less than 80 Arms of Protection stacks	 it loses its invincibility and begins to attack. Every turn it summons 2 Avatars of Gathering.
When it takes damage	 1 Arms of Protection stack is removed.
703134	Hecatoncheires	5. When Arms of Protection reaches 0	 Hecatoncheires enters the <color=#FF423F>Last Stand</color> state.
Last Stand: Damage is significantly increased	 and attack pattern changes.
704011	The Velvet Trials	1. Ara Mitama governs <color=#FF423F>courage</color>	 Nigi Mitama governs <color=#FF423F>affection</color>	 Saki Mitama governs <color=#FF423F>love</color>	 and Kushi Mitama governs <color=#FF423F>wisdom</color>.
2. The four Mitama share a Soul Link	 which distributes all damage received between all Shadows who share this condition	 based on the percentage of their current HP.
3. According to the mysterious words	 you must <color=#FF423F>select the corresponding Mitama to attack</color>.
704021	The Velvet Trials	1. Thoth loves the number <color=#FF423F>50</color>	 and at the end of each turn	 it randomly gives itself a Count from 1-100.
The Phantom Thieves can increase or decrease the Count by attacking surrounding Shadows.
2. If the Count is close to 50 at the start of Thoth's turn	 he will be happy and give the Phantom Thief some sort of benefit.
However	 if he is not happy	 he will give a penalty.
704031	The Velvet Trials	1. At the start of battle	 all Phantom Thieves will gain 10 stacks of Great Tengu Power.
Each stack increases Attack and Defense by 5%.
2. Every turn	 as well as every time the Phantom Thief uses a skill	 they lose 1 Great Tengu Power and Kurama Tengu gains 1 Great Tengu Power.
3. Kurama Tengu will summon Sudama	 who will flee after 1 turn.
If Sudama is defeated	 all Phantom Thieves gain 5 stacks of Great Tengu Power.
704041	The Velvet Trials	1. Every turn	 as well as every time the Phantom Thieves use a skill	 the entire party gains 1 stack of Great Tengu Power.
2. When the Phantom Thieves take damage	 they lose 3 stacks of Great Tengu Power.
3. When Great Tengu Power reaches a certain number of stacks	 an additional effect is gained.
5 stacks: damage increases by 20%.
10 stacks: damage increases by 50%.
704051	The Velvet Trials	Thoth selects 1 Phantom Thief and uses Elemental Cascade	 inflicting <color=#FF423F>4 types of elemental ailments</color> on the target.
On the next turn	 Thoth uses <color=#FF423F>Freidyne: Ultra</color> on that Phantom Thief.
This skill deals extra damage to targets with elemental ailments.
704061	The Velvet Trials	Each time a Phantom Thief <color=#FF423F>gains a buff</color>	 their damage increases by 10%.
Stacks up to 5 times.
704071	The Velvet Trials	Protecting the Queen's Necklace is the key to victory.
Restoring the Queen's Necklace's HP to the maximum will win the battle.
808211	Unique Shadow Abilities	1. When Decarabia takes <color=#FF423F>weakness damage</color>	 it will permanently gain 1 <color=#FF423F>Weakness</color> stack.
Each stack increases Decarabia's damage taken.
2. When Decarabia takes damage from an attribute other than its weakness	 it will immediately use <color=#FF423F>Agilao</color> against the attacker.
808221	Unique Shadow Abilities	1. When Decarabia takes <color=#FF423F>weakness damage</color>	 it will permanently gain 1 <color=#FF423F>Weakness</color> stack.
Each stack increases Decarabia's damage taken.
2. When Decarabia takes damage from an attribute other than its weakness	 it will immediately use <color=#FF423F>Agilao</color> against the attacker.
808222	Unique Shadow Abilities	3. At the start of battle	 Decarabia will summon 1 Courageous Spirit.
4. When Courageous Spirit is present	 <color=#FF423F>Decarabia's weak affinity will change</color>.
5. When Courageous Spirit is defeated	 Decarabia's weak affinity will return to normal.
808231	Unique Shadow Abilities	1. On Leanan Sidhe's action	 1 random Shadow gains 3 stacks of <color=#FF423F>Fairy's Blessing</color>.
Fairy's Blessing: Significantly increases damage.
Lose 1 stack after taking damage.
808232	Unique Shadow Abilities	2. On Leanan Sidhe's action	 for each Shadow with Fairy's Blessing	 the count increases by 1.
When the count reaches 2	 Fairy's Dance activates	 dealing heavy damage to all Phantom Thieves.
808241	Unique Shadow Abilities	1. On Leanan Sidhe's action	 it gains 4 stacks of <color=#FF423F>Fairy's Blessing</color>.
It loses 1 stack when it takes damage.
2. On Leanan Sidhe's action	 if it has Fairy's Blessing	 it activates <color=#FF423F>Gift of the Grove</color>.
All Shadows' damage is significantly increased. Lasts for 2 turns.
808251	Unique Shadow Abilities	1. On Leanan Sidhe's action	 Koppa Tengu gains 2 stacks of <color=#FF423F>Fairy's Blessing</color>.
Fairy's Blessing: Significantly increases damage.
Lose 1 stack after taking damage.
808252	Unique Shadow Abilities	2. When Koppa Tengu does not have Fairy's Blessing	 Leanan Sidhe will grant it Fairy's Protection	 which <color=#FF423F>nullifies all damage</color>.
The effect lasts until Leanan Sidhe's next action.
808261	Unique Shadow Abilities	1. Matador's skillful footwork raises its evasion.
Mirage Step: 100% chance to avoid <color=#FF423F>normal attacks</color>.
Reverse Step: 100% chance to avoid <color=#FF423F>ranged attacks</color>.
Cape-Sweep Step: 100% chance to avoid <color=#FF423F>skill attacks</color>.
808262	Unique Shadow Abilities	2. At the end of each turn	 Matador gains <color=#FF423F>1 random Step effect</color> and 3 Capote stacks.
It will lose 1 stack when taking damage.
3. If Matador has Capote when it takes action	 it will use Estocada to deal heavy damage to 1 Phantom Thief.
808271	Unique Shadow Abilities	1. Matador's skillful footwork raises its evasion.
Mirage Step: 100% chance to avoid <color=#FF423F>normal attacks</color>.
Reverse Step: 100% chance to avoid <color=#FF423F>ranged attacks</color>.
Cape-Sweep Step: 100% chance to avoid <color=#FF423F>skill attacks</color>.
808272	Unique Shadow Abilities	2. At the end of each turn	 all Matadors gain<color=#FF423F>2 random Step effects</color> and 1 Capote stacks.
It will lose 1 stack when taking damage.
3. If Matador has Capote when it takes action	 it will use Estocada to deal heavy damage to 1 Phantom Thief.
808281	Unique Shadow Abilities	1. Matador has <color=#FF423F>Master Step</color>	 granting a 100% chance to evade all attacks.
2. At regular intervals	 Matador will summon Matador's Spirit	 which will flee after 1 turn.
808282	Unique Shadow Abilities	3. When Matador's Spirit is defeated	 Matador will lose its motivation	 and also lose Master Step.
It will become unable to act for 2 turns.
After 2 turns	 its motivation will return	 and it will regain Master Step.
808291	Unique Shadow Abilities	1. Matador's skillful footwork raises its evasion.
Mirage Step: 100% chance to avoid <color=#FF423F>normal attacks</color>.
Reverse Step: 100% chance to avoid <color=#FF423F>ranged attacks</color>.
Cape-Sweep Step: 100% chance to avoid <color=#FF423F>skill attacks</color>.
808292	Unique Shadow Abilities	2. At the start of battle	 Matador gains <color=#FF423F>2 random Step effects</color>. After taking damage	 it will change to 2 other random Step effects.
3. At the end of each turn	 Matador gains 3 Capote stacks.
It loses 1 stack when taking damage.
4. If Matador has Capote when it takes action	 it will use Estocada to deal heavy damage to 1 Phantom Thief.
809111	Unique Shadow Abilities	1. Fuu-Ki's <color=#FF423F>Wind Domain</color> give it a base chance of 80% to put the target in an <color=#FF423F>Ultrawindswept</color> state when attacking. Ultrawindswept lasts for 2 turns.
Ultrawindswept: An enhanced version of Windswept inflicted by Fuu-Ki. Decreases Defense by 24%.
2. Fuu-Ki deals increased damage to Phantom Thieves in the Ultrawindswept state.
809121	Unique Shadow Abilities	3. Sui-Ki's <color=#FF423F>Ice Domain</color> gives it a base chance of 80% to inflict <color=#FF423F>Ultrafreeze</color> when attacking. Ultrafreeze lasts for 2 turns.
Ultrafreeze: An enhanced version of Frozen inflicted by Sui-Ki. Decreases Attack Power by 24%.
4. Sui-Ki deals increased damage to Phantom Thieves in the Ultrafreeze state.
809131	Unique Shadow Abilities	1. Kin-Ki's <color=#FF423F>Golden Domain</color> allows it to grant <color=#FF423F>Indestructible Vajra</color> to 1 random Shadow after dealing damage.
Indestructible Vajra: Nullifies the next damage taken.
2. When Kin-Ki has Indestructible Vajra	 its damage increases.
809141	Unique Shadow Abilities	1. Fuu-Ki's <color=#FF423F>Wind Domain</color> give it a base chance of 80% to put the target in an <color=#FF423F>Ultrawindswept</color> state when attacking. Ultrawindswept lasts for 2 turns.
Ultrawindswept: An enhanced version of Windswept inflicted by Fuu-Ki. Decreases Defense by 24%.
809142	Unique Shadow Abilities	2. Sui-Ki's <color=#FF423F>Ice Domain</color> gives it a base chance of 80% to inflict <color=#FF423F>Ultrafreeze</color> when attacking. Ultrafreeze lasts for 2 turns.
Ultrafreeze: An enhanced version of Frozen inflicted by Sui-Ki. Decreases Attack Power by 24%.
809143	Unique Shadow Abilities	3. Kin-Ki's <color=#FF423F>Golden Domain</color> allows it to grant <color=#FF423F>Indestructible Vajra</color> to 1 random Shadow after dealing damage.
Indestructible Vajra: Nullifies the next damage taken.
809144	Unique Shadow Abilities	4. Ongyo-Ki starts with 3 stacks of <color=#FF423F>Damage Reduction</color>	 which increases the damage dealt to Phantom Thieves with elemental ailments.
5. When Fuu-Ki	 Sui-Ki	 or Kin-Ki are defeated	 Ongyo-Ki loses 1 stack of <color=#FF423F>Damage Reduction</color>.
It then gains the Domain effect from the defeated Shadow	 and its affinities change.
752011	Unique Shadow Abilities	1. When Shadows on the field use a certain skill	 all Shadows gain <color=#FF423F>Legion</color>.
2. When Legion reaches 5 stacks	 Power will activate a powerful multi-target skill.
3. When there are less than 2 Principalities on the field	 Power will spend all Legion stacks to summon 2 Principalities.
It can summon a maximum of 2 times during the battle.
752021	Unique Shadow Abilities	1. When Ose activates <color=#FF423F>Revenge Stance</color>	 it enters a Counterattack Stance and will counterattack when it takes damage. <color=#FF423F>Revenge Stance</color> lasts for 2 turns.
When a counterattack is successful	 Attack increases.
2. After Revenge Stance ends	 targets who took counterattacks from Ose will be Taunted.
752031	Unique Shadow Abilities	1. Byakko's <color=#FF423F>Vicious Bite</color> skill will inflict <color=#FF423F>Deep Wounds</color> on all Phantom Thieves	 decreasing their Defense and increasing their damage taken.
Use the Guard command to remove the Deep Wounds condition.
2. Byakko's <color=#FF423F>Sharp Claws</color> skill will target the Phantom Thief with the lowest HP	 and if they have Deep Wounds	 the damage is increased.
When this skill KO's a Phantom Thief	 it immediately activates again.
752041	Unique Shadow Abilities	1. King Frost will not attack	 but will continuously summon Jack Frost and Black Frost.
When they are defeated	 King Frost loses 30% HP.
2. The longer Jack Frost and Black Frost stay on the field	 the more their Attack and Defense will increase.
752051	Unique Shadow Abilities	1. When Black Rider or Pale Rider take fatal damage	 they survive with 1 HP and enter a <color=#FF423F>False Death</color> state.
If both enter the False Death state at the same time	 they are defeated.
2. If either Black Rider or Pale Rider are in a False Death state at the start of the turn	 the other will use a skill to revive them.
This will also increase their Attack and max HP.
3. Black Rider's ability	 <color=#FF423F>Black Dance</color>: Increase the damage dealt by both Riders and decrease their damage taken.
Effect lasts until either Rider is defeated.
<color=#FF423F>Monochrome Rondeau: Black</color>: After reviving 2 or more times	 the Riders will activate Monochrome Rondeau: Black	 dealing heavy multi-target damage and inflicting Forget on the Phantom Thief with the lowest current HP.
4. Pale Rider's ability	 <color=#FF423F>White Dance</color>: Deals a set amount of damage to the Phantom Thief with the lowest Defense	 and locks on.
<color=#ff0000>Monochrome Rondeau: White</color>: On the next turn after using White Dance	 deals heavy damage to the Phantom Thief that was locked on to	 if neither Rider is in the False Death state.
752061	Unique Shadow Abilities	1. Surt has the ability <color=#FF423F>Ragnarok</color>: All Shadows besides Surt have their max HP decreased by 20% each turn.
2. When Surt's HP is below 15%	 it goes Berserk	 restoring 20% of its HP and increasing its Attack by 20%.
If it still survives after 3 turns	 it activates <color=#FF423F>Blazing Apocalypse</color>	 and KO's all Phantom Thieves.
3. When Valkyrie is defeated	 Surt gains <color=#FF423F>Valkyrie's Blessing</color>	 increasing its damage.
753011	Unique Shadow Abilities	1. Each time Gabriel loses 33% of its max HP	 it summons Dominion.
When Dominion is on the field	 all of Gabriel's affinities change to Resist.
2. When Gabriel's HP falls below 33%	 it summons 2 Powers every 3 turns.
3. When Power is on the field	 all of Gabriel's affinities change to Null.
753061	Unique Shadow Abilities	When either Oberon or Titania is defeated	 the other will be unable to act for 2 turns.
After they recover	 their damage will be <color=#FF423F>significantly increased</color>.
753071	Unique Shadow Abilities	Dominion	 Power	 Principality	 and Archangel are in the <color=#FF423F>Soul Link</color> state	 and also have the <color=#FF423F>Sanctuary</color> state.
Soul Link: When a Shadow with Soul Link takes damage	 split the damage between all Shadows with Soul Link	 based on its current HP.
Sanctuary: Increase damage taken by 6% per  <color=#FF423F>debuff</color> inflicted	 up to 30%.
753081	Unique Shadow Abilities	1. Cu Chulainn's <color=#FF423F>critical damage</color> is increased by 30%	 and Critical damage taken is decreased by 50%.
2. Cu Chulainn will activate Heroic Strength	 granting itself a Shield at a set amount	 increasing its damage	 and locking on to 1 Phantom Thief.
On the next turn	 it unleashes <color=#FF423F>Gae Bolg</color>on the targeted Phantom Thief	 dealing heavy damage with a chance of insta-killing.
If Cu Chulainn's <color=#FF423F>Shield is broken</color>	 it loses Heroic Strength and the lock on is canceled.
753091	Unique Shadow Abilities	1. When Yamata-no-Orochi's HP reaches 0	 it revives with new affinities and skills. It can revive up to 4 times.
2. After reviving 4 times	 Yamata-no-Orochi will begin preparing and summon a Serpent's Tail.
3. When a Serpent's Tail is defeated	 all Phantom Thieves gain <color=#FF423F>Ame-no-Murakumo</color>	 which greatly increases the damage of their next attack.
4. When Yamata-no-Orochi is defeated	 4 Shadows appear.
753111	Unique Shadow Abilities	1. When Arahabaki and Take-Minakata take damage from a skill	 Resonance	 or Highlight	 they will record the attribute of the damage taken. (If damage from multiple attribute types is taken in the same turn	 an attribute is recorded at random).
2. When Arahabaki takes damage of the <color=#FF423F>same attribute</color> it previously recorded	 its <color=#FF423F>damage taken increases</color>.
This effect can stack.
 When Arahabaki takes damage of a different attribute than the one it recorded	 the increased damage taken effect is removed	 and Arahabaki's damage increases.
3.When Take-Minakata takes damage of a <color=#FF423F>different attribute</color> than what it previously recorded	 its <color=#FF423F>damage taken increases</color>.
This effect can stack.
When Take-Minakata takes damage of the same attribute as the one it recorded	 the increased damage taken effect is removed	 and Take-Minakata's damage increases. 
753121	Unique Shadow Abilities	During battle	 Kohryu will summon Shadows of Seiryu	 Byakko	 Suzaku	 and Genbu.
When a Shadow is summoned	 its corresponding <color=#FF423F>Might</color> is granted to all Shadows on the field.
When a Shadow is defeated	 the Shadows lose that Might and it is granted to all Phantom Thieves instead.
Seiryu's Might: Grants a Shield equal to 10% of max HP every turn.
Byakko's Might: Increases Attack by 20%.
Suzaku's Might: Increases damage dealt by 20%.
Genbu's Might: Increases Defense by 20%.
753131	The Three Fates	1. Clotho uses Moirai Binding to grant a random Phantom Thief the Thread of Fate.
2. Lachesis uses Moirai Spinning to change a Phantom Thief's Thread of Fate to <color=#FF423F>Weave of Fate</color>.
Weave of Fate: Attack increases due to the threads of fate.
3. At certain times	 Clotho	 Lachesis and Atropos will summon a Spirit of Fate.
Defeating the Spirit of Fate will grant an <color=#FF423F>additional strengthening effect</color> to Phantom Thieves with the Weave of Fate.
4. At certain times	 Atropos will use <color=#FF423F>Moirai Cutting</color>	 dealing severe damage to Phantom Thieves with the Weave of Fate.
(1) After Atropos has acted 10 times.
(2) After Clotho or Lachesis have been defeated.
(3) After Atropos has been defeated.
753141	Hecatoncheires	1. At the start of the battle	 Hecatoncheires has 100 <color=#FF423F>Arms of Protection</color> stacks	 and takes less damage depending on the number of stacks. When it has Arms of Protection	 it also has <color=#FF423F>Arms of Defense</color>	 reducing final damage by 70%.
2. Hecatoncheires will summon the Avatar of Arms and the Avatar of Gathering.
When the Avatar of Arms is defeated	 it loses 1 Arms of Protection stack. When the Avatar of Gathering is defeated	 it loses 10 Arms of Protection stacks.
For each Arms of Protection stack removed	 all Phantom Thieves gain <color=#FF423F>Arms of Strength</color>.
Arms of Strength: Damage increased based on number of stacks.
3. When Hecatoncheires has 80 or more Arms of Protection stacks	 it becomes invincible and will not attack.
It keeps 4 Avatars of Arms on the field	 and gains 1 <color=#FF423F>Arms of Might</color> stack every turn.
Arms of Might: Damage increased based on number of stacks.
4. When Hecatoncheires has less than 80 Arms of Protection stacks	 it loses its invincibility and begins to attack. Every turn it summons 2 Avatars of Gathering.
When it takes damage	 1 Arms of Protection stack is removed.
5. When Arms of Protection reaches 0	 Hecatoncheires enters the <color=#FF423F>Last Stand</color> state.
Last Stand: Damage is significantly increased	 and attack pattern changes.
900111	Combat Chip	<color=#FF423F>Combat Chips</color>:
1. At the end of each turn	 the Phantom Thieves receive 3 <color=#FF423F>Deployment Points</color>.
2. After reaching 20 Deployment Points	 automatically spend 20 Deployment Points to summon 1 <color=#FF423F>Self-Destruct Bot</color> and 1 <color=#FF423F>Combat Drone </color>(number can increase depending on equipment)	 which will attack the enemy.
3. Each Combat Chip has special effects.
900112	Combat Drones	<color=#FF423F>Combat Drones</color>:
1. For each Bot equipped	 gain 1 Combat Drone	 and 1 more <color=#FF423F>Data Abnormality</color> can be removed.
2. Each Combat Drone has special effects.
900113	Self-Destruct Bot	<color=#FF423F>Self-Destruct Bots</color>:
1. For each Bot equipped	 gain 1 extra Self-Destruct Bot	 and increase Self-Destruct Bots' <color=#FF423F>Almighty</color> damage dealt by 100%.
2. Each Self-Destruct Bot has special effects.
218121	Unique Shadow Abilities	tnxotb-[InstTutorials_text_218121]
218131	Unique Shadow Abilities	tnxotb-[InstTutorials_text_218131]
218141	Unique Shadow Abilities	tnxotb-[InstTutorials_text_218141]
218091	Unique Shadow Abilities	1. Jikokuten starts the battle with 10 Down Points.
Every 2 turns	 it activates <color=#FF423F>Sword that Defends the Nation</color>	 granting itself 10 Down Points	 and granting 1 Down Point to all Shadows.
When Jikokuten's Down Points reach 36	 it transforms into <color=#FF423F>Asura</color>	 greatly enhancing its abilities.
2. Jikokuten constantly summons various Shadows.
When a Shadow is defeated	 Jikokuten's Down Points are reduced by 3.
3. You can win by reducing Jikokuten's Down Points to 0	 or by defeating it.
218101	Unique Shadow Abilities	1. Jikokuten starts the battle with 20 Down Points	 and gains 4 Down Points every turn.
When Jikokuten's Down Points reach 36	 it transforms into <color=#FF423F>Asura</color>	 greatly increasing its stats.
2. Jikokuten summons 4 Mitama every 3 turns.
The Mitama will flee after 1 turn.
When a Mitama is defeated	 Jikokuten's Down Points are reduced by 3	 and one of its affinities becomes Weak for 3 turns: Fire	 Ice	 Electric	 or Wind.
3. The Phantom Thieves can win by reducing Jikokuten's Down Points to 0	 or by defeating it.
218111	Unique Shadow Abilities	1. Jikokuten starts the battle with 30 Down Points	 all affinities set to Null	 and gains 3 extra Down Points every turn.
When Jikokuten's Down Points reach 36	 it transforms into <color=#FF423F>Asura</color>	 greatly increasing its stats.
2. At the start of battle	 Jikokuten spends 6 Down Points to summon Jikokuten's Spirit.
3. Jikokuten's Spirit has 4 Down Points. Each turn	 4 of its weaknesses change.
If it is knocked down or defeated	 it becomes Crushed Spirit; Jikokuten loses 10 Down Points	 and all its affinities change to weaknesses (excluding Physical and Gun).
Jikokuten then resummons Jikokuten's Spirit.
4. Victory is granted once Jikokuten's Down Points reach 0	 or it is defeated.
218191	Unique Shadow Abilities	Each turn	 Kikuri-Hime will use a random Arbiter's Power on the Phantom Thieves	 preventing them from taking certain actions.
If the Phantom Thieves defy the arbitration	 they gain 1 Seal of Mortality	 and if they gain 2 seals	 they are KO'd.
Arbitration - Survival: Healing and Defense skills or Highlights must not be used.
Arbitration - Attack: Attack skills or Highlights must not be used.
Arbitration - Support: Buff and Debuff skills or Highlights must not be used.
If all Phantom Thieves obey the arbitration	 Kikuri-Hime will grant all Phantom Thieves a damage increase effect.
218201	Unique Shadow Abilities	At the start of the battle	 Kikuri-Hime activates Border of Life and Death	 greatly reducing the HP of all Phantom Thieves and activating Arbitration - Survival for 2 turns.
Afterwards	 it activates Arbitration - Attack and Arbitration - Support for all Phantom Thieves.
In addition	 every 2 turns	 Kikuri-Hime will use a random Arbiter's Power on the Phantom Thieves	 preventing them from taking certain actions.
If the Phantom Thieves defy the arbitration	 they gain 1 Seal of Mortality	 and if they gain 2 seals	 they are KO'd.
Arbitration - Survival: Healing and Defense skills or Highlights must not be used.
Arbitration - Attack: Attack skills or Highlights must not be used.
Arbitration - Support: Buff and Debuff skills or Highlights must not be used.
If all Phantom Thieves obey the arbitration	 Kikuri-Hime will grant all Phantom Thieves a damage increase effect.
218211	Unique Shadow Abilities	Every 3 turns	 Kikuri-Hime will activate Bond of Death	 randomly KO'ing 1 Phantom Thief.
It also uses a random Arbiter's Power on the other Phantom Thieves	 preventing them from taking certain actions.
If the Phantom Thieves defy the arbitration	 they gain 1 Seal of Mortality	 and if they gain 2 seals	 they are KO'd.
Arbitration - Survival: Healing and Defense skills or Highlights must not be used.
Arbitration - Attack: Attack skills or Highlights must not be used.
Arbitration - Support: Buff and Debuff skills or Highlights must not be used.
If all Phantom Thieves obey the arbitration	 Kikuri-Hime will revive the KO'd Phantom Thief.
218151	Unique Shadow Abilities	1. Zouchouten has Growth of all Things	 and each turn grants Growth to 1 Shadow.
2. If Jack Frost receives Growth	 it becomes King Frost. If King Frost receives Growth	 it becomes <color=#FF423F>Black Frost</color>	 and summons 1 Jack-o'-Lantern.
When Jack-o'-Lantern is defeated	 Black Frost reverts to Jack Frost.
218161	Unique Shadow Abilities	1. Zouchouten has <color=#FF423F>Growth of all Things</color>	 which grants Growth to 2 random Shadows each turn.
Each stack of Growth increases Attack by 30%.
2. Zouchouten will absorb Growth from the Shadows every 3 turns. When it reaches 4 stacks of Growth	 it will unleash a powerful attack.
3. When a Shadow with Growth is defeated	 its stack of Growth disappears.
218171	Unique Shadow Abilities	1. Zouchouten has <color=#FF423F>Growth of all Things</color>	 and every turn grants Growth to 1 random Shadow and 1 random Phantom Thief.
Each stack of Growth increases damage dealt by 30%	 but also increases damage taken by 30%.
2. When a target with Growth is defeated	 the attacker takes their Growth.
218181	Unique Shadow Abilities	1. Zouchouten has <color=#FF423F>Growth of all Things</color>. It starts with 10 stacks of Growth	 and each turn gains 5-8 stacks of Growth	 up to a maximum of 30.
2. When Zouchouten takes damage	 it loses 1 stack of Growth.
If its stacks of Growth fall below 8	 it immediately grants itself 10 stacks of Growth.
3. After 4 turns	 or when Growth has reached 20 stacks	 it transforms into <color=#FF423F>Asura</color>	 greatly enhancing its abilities.
218221	Unique Shadow Abilities	1. Arahabaki summons a variety of Dogu.
When Dogu are on the field	 Arahabaki is granted various effects.
2. At the start of Arahabaki's turn	 Arahabaki's Progress increases for each Dogu on the field.
When Progress reaches 10	 Arahabaki activates <color=#FF423F>Abyssal Gaze</color> and inflicts all Phantom Thieves with <color=#FF423F>Despair</color>.
3. At the start of the battle or when its HP falls below 50%	 Arahabaki summons 1 of each of the 4 types of Dogu.
Weakness Dogu: Protects Arahabaki's weakness
When defeated	 several of Arahabaki's affinities change to Weak.
SP Dogu: Causes the Phantom Thieves to lose SP each turn.
When defeated	 the Phantom Thieves regain SP.
HP Dogu: Restores Arahabkaki's HP each turn. When defeated	 the Phantom Thieves regain HP.
Progress Dogu: Increases Arahabaki's Progress each turn.
When defeated	 Arahabaki's Progress decreases.
218231	Unique Shadow Abilities	1. Arahabaki summons a variety of Dogu.
When Dogu are on the field	 Arahabaki is granted various effects.
2. At the start of Arahabaki's turn	 Arahabaki's Progress increases for each Dogu on the field.
When Progress reaches 10	 Arahabaki activates <color=#FF423F>Abyssal Gaze</color> and inflicts all Phantom Thieves with <color=#FF423F>Despair</color>.
3. Arahabaki will randomly summon 2 Dogu each turn.
When its HP falls below 50%	 Arahabaki summons an additional of Dogu.
Weakness Dogu: Protects Arahabaki's weakness
When defeated	 several of Arahabaki's affinities change to Weak.
SP Dogu: Causes the Phantom Thieves to lose SP each turn.
When defeated	 the Phantom Thieves regain SP.
HP Dogu: Restores Arahabkaki's HP each turn. When defeated	 the Phantom Thieves regain HP.
Progress Dogu: Increases Arahabaki's Progress each turn.
When defeated	 Arahabaki's Progress decreases.
218241	Unique Shadow Abilities	1. Arahabaki summons a variety of Dogu. When Dogu are on the field	 Arahabaki is granted various effects.
2. At the start of Arahabaki's turn	 Arahabaki's Progress increases for each Dogu on the field. When Progress reaches 10	 Arahabaki activates Abyssal Gaze and inflicts all Phantom Thieves with <color=#ff3b37>Despair</color>.
3. There is always a Metamorphosis Dogu on the field. This Dogu cannot be attacked	 and it will transform into another Dogu randomly every turn	 activating its corresponding ability.
4. When it HP falls below 50% for the first time	 Arahabaki summons an additional Metamorphosis Dogu.
Weakness Dogu: Protects Arahabaki's weakness.
SP Dogu: Causes the Phantom Thieves to lose SP each turn.
HP Dogu: Restores Arahabkaki's HP each turn.
Progress Dogu: Increases Arahabaki's Progress each turn.
818011	Unique Shadow Abilities	1. Setanta will transform into <color=#FF423F>Cu Chulainn</color> under certain circumstances.
2. Cu Chulainn will lock on to 1 Phantom Thief	 and will activate <color=#FF423F>Gae Bolg</color> on the next turn	 dealing heavy damage with a chance to insta-kill.
818021	Unique Shadow Abilities	1. Leanan Sidhe grants 1 Growth stack to Setanta every turn. When Growth reaches 3 stacks	 Setanta transforms into <color=#FF423F>Cu Chulainn</color>.
2. When Leanan Sidhe is defeated	 Setanta gains 3 Growth stacks.
3. Cu Chulainn will lock on to 1 Phantom Thief	 and will activate <color=#FF423F>Gae Bolg</color> on the next turn	 dealing heavy damage with a chance to insta-kill.
818031	Unique Shadow Abilities	1. Take-Minakata deals more damage the lower its HP is.
2. Whenever Take-Minakata uses a skill	 it loses 20% of its current HP	 and gains a Shield equal to 20% of its max HP.
3. Every 3 turns	 Take-Minakata summons 1 War God's Spirit. If it is defeated in 1 turn	 all Phantom Thieves' Attack is increased.
If it is not defeated in 1 turn	 Take-Minakata absorbs the War God's Spirit	 and gains a Shield equal to 50% of its max HP.
818041	Unique Shadow Abilities	1. Take-Minakata deals more damage the lower its HP is.
2. Take-Minakata will take 90% of the damage for other Shadows	 and when it receives fatal damage	 it will instead enter an Endure state	 its HP will be fixed at 1	 and will die after 2 turns.
818051	Unique Shadow Abilities	1. Take-Minakata deals more damage the lower its HP is.
2. When Take-Minakata's HP is low	 it will summon 4 War God's Spirits	 and after 1 turn absorb all of them.
For each one absorbed	 it restores 25% of its max HP.
If the Phantom Thieves defeat all of the War God's Spirits	 Take-Minakata will be defeated.
818091	Unique Shadow Abilities	1. Thoth is the god of the Moon	 and Horus is the god of the Sun.
They govern over day and night respectively. If Thoth is attacked	 it will become night. If Horus is attacked	 it will become day.
2. During the day	 Thoth's damage is decreased by 70%	 and its damage taken is increased by 70%.
At night	 its damage is increased by 70%	 and its damage taken is decreased by 70%.
The effects of day and night on Horus are the opposite.
818101	Unique Shadow Abilities	1. Each turn	 Thoth's affinity will change to Drain either Fire	 Ice	 Electric	 Wind	 Psychokinesis	 Nuclear	 Bless	 or Curse. When it takes damage of the corresponding attribute	 it gains 1 Lunar Power stack.
2. When Thoth has 2 or more Lunar Power stacks	 it will spend 2 Lunar Power stacks to enter the <color=#FF423F>Full Moon</color> state	 increasing its own abilities and summoning 2 Sandmen.
3. Every 3 turns	 Thoth will use Full Moon's Protection	 entering a preparation state and gaining a Shield.
If the Shield is destroyed before the next turn	 the preparation is canceled. If it is not destroyed	 Thoth immediately enters the Full Moon state.
818111	Unique Shadow Abilities	1. The moon changes phases	 starting with New Moon.
It follows a sequence of New Moon	 Waxing Crescent	 Full Moon	 and Waning Crescent.
2. Depending on the phase of the moon	 Thoth gains the following effects.
New Moon: Damage decreases by 50%	 and damage taken increases by 50%.
Waxing Crescent: Damage increases by 50%	 and damage taken increases by 50%.
Full Moon: Damage increases by 50%	 and damage taken decreases by 50%.
Waning Crescent: Damage decreases by 50%	 and damage taken decreases by 50%.
3. When a Clock is on the field	 and it is attacked by different attributes	 the phase of the moon will change.
Fire	 Ice	 Electric	 and Wind attacks will change the phase in the usual order.
Psychokinesis	 Nuclear	 Bless and Curse attacks will change the phase in reverse order.
818121	Unique Shadow Abilities	1. The day and night cycle switches every turn.
During the day	 SP cost is greatly increased and damage dealt is increased.
At night	 all units enter a <color=#FF423F>Deep Sleep</color>state.
Deep Sleep: Unable to act	 and restore 20% of max HP and 20% of max SP every turn.
2. At night	 Thoth summons 1 Sandman.
Each Sandman on the field extends the duration of night by 1 turn.
819111	Unique Shadow Abilities	Jikokuten has <color=#FF423F>Sword that Defends the Nation</color>.
Sword that Defends the Nation: Each time damage is dealt	 also grants a shield to 1 random Shadow.
819121	Unique Shadow Abilities	Zouchouten can activate <color=#FF423F>Growth of all Things</color>.
Growth of all Things: Randomly increases Attack	 Defense	 or Damage of all Shadows each turn.
819131	Unique Shadow Abilities	Koumokuten can activate <color=#FF423F>Eye of Heaven</color>.
Eye of Heaven: Selects 1 Phantom Thief. Increases their damage taken and has Shadows focus attacks on them next turn.
2. After activating Eye of Heaven	 Koumokuten will summon 1 Makami.
819141	Unique Shadow Abilities	Bishamonten can activate <color=#FF423F>Parasol of Chaos</color>.
Parasol of Chaos: Covers the Shadow with the lowest HP percentage	 and changes all affinities to Drain. Lasts for 2 turns.
819151	Unique Shadow Abilities	1. Jikokuten has <color=#FF423F>Sword that Defends the Nation</color>.
Sword that Defends the Nation: Each time damage is dealt	 also grants a shield to 1 random Shadow.
2. Zouchouten can activate <color=#FF423F>Growth of all Things</color>.
Growth of all Things: Randomly increases Attack	 Defense	 or Damage of all Shadows each turn.
3. Koumokuten can activate <color=#FF423F>Eye of Heaven</color>.
Eye of Heaven: Selects 1 Phantom Thief.
Increases their damage taken and has Shadows focus attacks on them next turn.
4. Bishamonten has <color=#FF423F>Parasol of Chaos</color>.
Parasol of Chaos: Covers the Shadow with the lowest HP	 and changes all elemental affinities to Resist.
Lasts for 2 turns.
819152	Unique Shadow Abilities	5. When only 1 of the Four Heavenly Kings remains	 it transforms into <color=#FF423F>Asura</color>	 and restores 30% HP.
6. Asura has the skills of all Four Heavenly Kings	 so fight with caution.
730111	Unique Shadow Abilities	Dominion	 Power	 Principality	 and Archangel are in the <color=#ff3b37>Soul Link</color> state.
Soul Link: When a Shadow with Soul Link takes damage	 split the damage between all Shadows with Soul Link	 based on its current HP.
Dominion will summon continuous waves of Angels. When an Angel is defeated	 SP is restored.
Dominion will summon continuous waves of Angels. When an Angel is defeated	 SP is restored.
Damage dealt to Angels is added to your score.
730611	Unique Shadow Abilities	Archangel will summon continuous waves of Angels. When an Angel is defeated	 SP is restored.
Damage dealt to Angels is added to your score.
731111	Unique Shadow Abilities	During battle	 Kohryu will summon Shadows of Seiryu	 Byakko	 Suzaku	 and Genbu.
When a Shadow is summoned	 its corresponding Might is granted to all Shadows on the field.
When a Shadow is defeated	 the Shadows lose that Might and it is granted to all Phantom Thieves instead.
Seiryu's Might: Grants a Shield equal to 10% of max HP every turn.
Byakko's Might: Increases Attack by 20%.
Suzaku's Might: Increases damage dealt by 20%.
Genbu's Might: Increases Defense by 20%.
732111	Unique Shadow Abilities	1. After the Phantom Thieves land 3 critical hits with their skills	 the Phantom Thief with the highest Attack can act for 1 extra turn	 and their critical rate and critical damage are increased.
2. Oberon and Titania are in the <color=#FF423F>Soul Link</color> state.
Soul Link: Distributes all damage received between all Shadows who share this condition	 based on the percentage of their current HP.
3. Every 2 turns	 Oberon's damage taken increases	 then gradually decreases.
Every 2 turns	 Titania's damage taken decreases	 then gradually increases.
4. Oberon will summon Sudama	 which will attempt to flee.
If Sudama is defeated	 the Phantom Thief with the highest Attack will be able to act for 1 extra turn	 and their critical rate and critical damage are increased.
733111	Unique Shadow Abilities	1. Surt grants <color=#FF423F>Ragnarok</color> to Shadows every turn.
Ragnarok: Damage increases by 5%	 and lose a set amount of HP each turn.
Stacks up to 10 times.
2. When Baphomet is defeated	 Surt loses a certain amount of HP.
3. When Weakened	 Surt will grant 5 stacks of Ragnarok to all Phantom Thieves	 and summon 4 Jack-o'-Lanterns.
Damage dealt to Jack-o'-Lanterns is added to your score.
733611	Unique Shadow Abilities	1. Surt grants 2 stacks of <color=#FF423F>Ragnarok</color> to all Shadows every turn.
Ragnarok: Damage increases by 5%	 and lose a set amount of HP each turn.
Stacks up to 10 times.
2. Damage dealt to Jack-o'-Lantern is added to your score.
734111	Unique Shadow Abilities	When Vishnu's HP falls below 90%/60% for the first time	 it summons 2 Avatars.
The Avatars and Vishnu's main body are in the <color=#FF423F>Soul Link</color> state.
Soul Link: Distributes all damage received between all Shadows who share this condition	 based on the percentage of their current HP.
734611	Unique Shadow Abilities	Vishnu's Avatars and its main body are in the <color=#FF423F>Soul Link</color> state.
Soul Link: Distributes all damage received between all Shadows who share this condition	 based on the percentage of their current HP.
735111	Unique Shadow Abilities	When Atavaka takes damage from a skill	 it gains a Mark based on that skill's <color=#FF423F>attribute</color>.
The maximum number of Marks is 7.
When it has collected 3 Marks of the same attribute	 Atavaka spends all Marks to summon a Rakshasa.
When Rakshasa is defeated	 the corresponding attribute damage of all Phantom Thieves is increased.
Atavaka can summon Rakshasa up to 2 times.
736111	Unique Shadow Abilities	1. Yatsufusa will activate the <color=#FF423F>Eight Beads of Virtue</color>: All affinities change to Resist	 damage increases	 and damage taken decreases.
It also summons 4 Elemental Souls.
When an Elemental Soul is defeated	 Yatsufusa is inflicted with the corresponding Elemental Ailment.
Lasts for 2 turns.
2. When Yatsufusa is in the Eight Beads of Justice state and is inflicted with all 4 types of Elemental Ailments	 the Eight Beads of Justice state is canceled and its Defense decreases.
3. When Yatsufusa is Weakened	 all Elemental Souls vanish	 and the Eight Beads of Justice state is canceled.
736611	Unique Shadow Abilities	1. Yatsufusa will activate the <color=#FF423F>Eight Beads of Virtue</color>: All affinities change to Resist	 damage increases	 and damage taken decreases.
It also summons 4 Elemental Souls.
When an Elemental Soul is defeated	 Yatsufusa is inflicted with the corresponding Elemental Ailment.
Lasts for 2 turns.
2. When Yatsufusa is in the Eight Beads of Justice state and is inflicted with all 4 types of Elemental Ailments	 the Eight Beads of Justice state is canceled and its Defense decreases.
737111	Unique Shadow Abilities	1. At the start of battle	 Mara summons 4 Decarabias.
2. Mara maintains 4 Decarabias on the field.
3. When Decarabia is defeated	 Mara loses a certain amount of HP.
4. When Weakened	 damage dealt to Decarabia is added to your score.
738111	Unique Shadow Abilities	1. Nidhoggr and the Vipers are in the <color=#FF423F>Soul Link</color> state.
Soul Link: Distributes all damage received between all Shadows who share this condition	 based on the percentage of their current HP.
2. When Nidhoggr and Vipers use skills	 all skill targets are inflicted with 1 stack of <color=#FF423F>Poison</color>.
Poison: At the end of a Phantom Thief's action	 lose a certain about of HP for each stack	 but also increase Attack by 10%.
Poison cannot be dispelled and can stack up to 3 times.
3. When Weakened	 damage dealt to Vipers is added to your score.
738611	Unique Shadow Abilities	1. Nidhoggr and the Vipers are in the <color=#FF423F>Soul Link</color> state.
Soul Link: Distributes all damage received between all Shadows who share this condition	 based on the percentage of their current HP.
2. When Nidhoggr and Vipers use skills	 all skill targets are inflicted with 1 stack of <color=#FF423F>Poison</color>.
Poison: At the end of a Phantom Thief's action	 lose a certain about of HP for each stack	 but also increase Attack by 10%.
Poison cannot be dispelled and can stack up to 3 times.
739111	Unique Shadow Abilities	1. When Baal takes skill damage or receives a debuff	 it gains 1 stack of <color=#FF423F>Decline</color>.
Decline: Decreases Defense. Lasts 3 turns.
Stacks up to 15 times.
2. Baal will start preparing	 and on the next turn	 uses <color=#FF423F>Divine Spear of Baal</color>	 dealing heavy damage to 1 target.
If Decline reaches 10 stacks while preparing	 the preparation is canceled and the attack changes to Cleave.
Baal's single-target attacks will prioritize Assassin or Sweeper Phantom Thieves.
740111	Unique Shadow Abilities	1. Kartikeya leads its army of birds to attack all at once.
2. When Garuda and Jatayu take damage from a Phantom Thief	 that Thief's damage increases by 4%.
Lasts for 3 turns. Stacks up to 5 times.
When Horus and Yatagarasu take damage from a Phantom Thief	 that Thief's Pierce Rate increases by 2%.
Lasts for 3 turns. Stacks up to 5 times.
741111	Unique Shadow Abilities	When Oumitsunu takes damage from a skill	 Highlight	 or Resonance	 the damage of the corresponding attribute increases by 6%.
Lasts for 3 turns. Stacks up to 8 times.
228011	Unique Shadow Abilities	1. When Angel takes damage	 Anubis gains 1 <color=#FF423F>Judgment of Evil</color>.
2. When Succubus takes damage	 Anubis gains 1 <color=#FF423F>Judgment of Good</color>.
3.Judgment of Good and Judgment of Evil <color=#FF423F>negate</color> each other.
4. When either Judgment of Good or Judgment of Evil reach 5 stacks	 Anubis will use <color=#FF423F>Advent of Judgment</color>	 dealing heavy damage to all Phantom Thieves.
5. If Angel does not take any damage for 1 turn	 it will use <color=#FF423F>Angel Healing</color> to restore HP to all Shadows.
6. If Succubus does not take any damage for 1 turn	 it will use <color=#FF423F>Succubus Lullaby</color>	 which has a 75% chance to put 2 random Phantom Thieves to Sleep.
228021	Unique Shadow Abilities	1. When Anubis receives a debuff	 it gains 1 <color=#FF423F>Judgment of Evil</color>.
2. When Anubis receives a buff	 it gains 1 <color=#FF423F>Judgment of Good</color>.
3.Judgment of Good and Judgment of Evil <color=#FF423F>negate</color> each other.
4. When either Judgment of Good or Judgment of Evil reach 5 stacks	 Anubis will use <color=#FF423F>Advent of Judgment</color>	 dealing heavy damage to all Phantom Thieves.
5. At the start of each turn	 Anubis will summon 1 Saki Mitama.
228031	Unique Shadow Abilities	1. When Phantom Thieves use debuffs or attack skills	 Anubis gains <color=#FF423F>Judgment of Evil</color>.
2. When Phantom Thieves use buffs or recovery skills	 Anubis gains <color=#FF423F>Judgment of Good</color>.
3. Judgment of Good and Judgment of Evil <color=#FF423F>negate</color> each other.
4. When either Judgment of Good or Judgment of Evil reach 5 stacks	 Anubis activates <color=#FF423F>Advent of Judgment</color>	 dealing heavy damage to all Phantom Thieves.
228041	Unique Shadow Abilities	1. Hariti has extremely high damage reduction	 making it difficult to deal damage with direct attacks.
2. When Hariti's turn ends	 it spends its own HP to fully heal all other Shadows	 losing HP equal to the amount healed.
3. At the start of Hariti's turn	 it summons 1 Agathion.
Hariti's damage increases by 30% for each Agathion on the field.
228051	Unique Shadow Abilities	1. Hariti has extremely high damage reduction	 making it difficult to deal damage with direct attacks.
2. When Hariti's turn ends	 it spends its own HP to fully heal all other Shadows	 losing HP equal to the amount healed.
3. When Jack-o'-Lantern is defeated	 Hariti immediately deals heavy damage to all Phantom Thieves.
4. At the start of Hariti's turn	 it summons up to 4 Jack-o'-Lanterns.
228061	Unique Shadow Abilities	1. Hariti has extremely high damage reduction	 making it difficult to deal damage with direct attacks.
2. When Hariti's turn ends	 it spends its own HP to fully heal all other Shadows	 losing HP equal to the amount healed.
3. Each turn	 Hariti summons 1 Jack Frost	 and grants <color=#FF423F>Mother's Love</color> to a random Jack Frost.
4. A Jack Frost with Mother's Love will grow into Black Frost after 2 turns	 and will become unable to receive healing effects.
829011	Unique Shadow Abilities	1. At the end of each turn	 Hell Biker will inflict <color=#FF423F>Hellscorched</color> on a random Phantom Thief.
Hellscorched: Lose a large amount of HP at the end of each turn.
 Can be removed after taking <color=#FF423F>Ice</color> damage.
Stacks up to 3 times.
2. Jack Frost will not attack unprovoked and cannot be defeated.
When damaged	 he will immediately use <color=#FF423F>Bufu</color> on the attacker	 dealing a small amount of <color=#FF423F>Ice</color> damage.
3. When Hell Biker is defeated	 you win the battle.
829021	Unique Shadow Abilities	1. At the end of each turn	 Hell Biker will inflict <color=#FF423F>Hellscorched</color> on a random Phantom Thief.
Hellscorched: Lose a large amount of HP at the end of each turn.
 Can be removed after taking <color=#FF423F>Ice</color> damage.
Stacks up to 3 times.
2. Jack Frost will not attack unprovoked and cannot be defeated.
When damaged	 he will immediately use <color=#FF423F>Bufu</color> on the attacker	 dealing a small amount of <color=#FF423F>Ice</color> damage.
829031	Unique Shadow Abilities	1. At the start of battle	 Unicorn gains 5 stacks of Purity.
2. When Unicorn receives a buff or healing	 it gains 1 extra stack of Purity.
Purity: Increases Attack and Defense. When Purity reaches 10 stacks	 Unicorn activates <color=#FF423F>Holy Power</color>.
Holy Power deals heavy damage to all Phantom Thieves and fully restores all Shadows' HP.
3. Every turn	 Unicorn randomly summons Nigi Mitama	 Saki Mitama	 Kushi Mitama	 or Ara Mitama	 which each grant Unicorn various buffs.
4. When Unicorn takes most <color=#FF423F>debuffs</color>	 it loses 2 stacks of Purity.
829041	Unique Shadow Abilities	1. At the start of the battle	 Unicorn gains 5 stacks of Purity.
2. When Unicorn is healed or receives a buff	 it also gains 1 stack of Purity.
Purity: Increases Attack and Defense	 and when Purity reaches 10 stacks	 Unicorn activates <color=#FF423F>Holy Power</color>.
Holy Power deals heavy damage to all Phantom Thieves	 and fully heals all Shadows.
3. If there are less than 4 Mitama on the field	 Unicorn will spend 3 Purity to summon 1 Mitama.
829051	Unique Shadow Abilities	1. Daisoujou cannot be targeted or defeated.
2. At the start of the battle	 Daisoujou's HP is only 1% of the maximum	 and each turn it will use <color=#FF423F>Sokushin</color>.
 Sokushin: Deals damage to all Phantom Thieves based on their current HP percentage	 and consumes a certain amount of SP. Also restores the same amount of HP to Daisoujou.
3. Shadows will continously appear on the field	 and deal a set amount of damage to Daisoujou.
4. Victory is acheived if Daisoujou's HP is healed to 100%.
The battle is lost if Daisoujou's HP is too low. Quickly defeat the Shadows while protecting Daisoujou.
829061	Unique Shadow Abilities	1. Daisoujou cannot be targeted or defeated.
2. Shadows and Sarasvati will appear on the field. Shadows will deal a set amount of damage to Daisoujou	 and Sarasvati will heal Daisoujou.
3. At the start of the battle	 Daisoujou has 1% of its max HP. Victory is acheived if Daisoujou's HP is healed to 100%.
The battle is lost if Daisoujou's HP is too low. Be mindful of Daisoujou's remaining HP.
4. Quickly defeat the Shadows while protecting Sarasvati.
829711	Unique Shadow Abilities	White Rider will use <color=#FF423F>White Pestilence</color>.
White Pestilence: All Phantom Thieves lose a certain amount of HP	 and 3 random Phantom Thieves are inflicted with <color=#FF423F>Pestilence</color>	 causing them to lose a certain amount of HP each turn.
Lasts for 3 turns and stacks up to 5 times.
829721	Unique Shadow Abilities	Red Rider will use <color=#FF423F>Red War</color>.
Red War: Increases damage of all Shadows.
Can be stacked. Also	 has a chance to inflict <color=#FF423F>Rage</color> on 2 random Phantom Thieves.
Lasts for 2 turns.
829731	Unique Shadow Abilities	1. Trumpeter cannot be targeted and will not attack.
2. Trumpeter will use <color=#FF423F>Horn of the End</color> to instantly activate other Shadows' skills.
3. If all other Shadows are defeated	 Trumpeter will become targetable and begins preparing the <color=#FF423F>Horn of Ruin</color> for 2 turns.
Horn of Ruin: Sacrifices self to resummon all defeated Shadows	 greatly strengthening their abilities and dealing heavy damage to all Phantom Thieves.
829741	Unique Shadow Abilities	1. Black Rider will use <color=#FF423F>Black Famine</color>.
Black Famine: Inflicts Famine on all targets	 decreasing their Attack and increasing the cost of skills. Lasts for 1 turn. Stacks up to 2 times.
2. Pale Rider will use <color=#FF423F>Pale Death</color>.
Pale Death: Deals damage based on current HP percentage to 1 target	 and inflicts <color=#FF423F>Despair</color>. Lasts for 3 turns.
829751	Unique Shadow Abilities	1. White Rider will use <color=#FF423F>White Pestilence</color>.
White Pestilence: All Phantom Thieves lose a certain amount of HP	 and 3 random Phantom Thieves are inflicted with <color=#FF423F>Pestilence</color>	 causing them to lose a certain amount of HP each turn. Lasts for 3 turns and stacks up to 5 times.
.
2. Red Rider will use <color=#FF423F>Red War</color>.
Red War: Increases damage of all Shadows. Can be stacked. It also has a chance to inflict <color=#FF423F>Rage</color> on 2 random Phantom Thieves. Lasts for 2 turns.
3. Black Rider will use <color=#FF423F>Black Famine</color>.
Black Famine: Inflicts Famine on all targets	 decreasing their Attack and increasing the cost of skills. Lasts for 1 turn and stacks up to 2 times.
.
4. Pale Rider will use <color=#FF423F>Pale Death</color>.
Pale Death: Deals damage based on current HP percentage to 1 target	 and inflicts <color=#FF423F>Despair</color>. Lasts for 3 turns.
5. Trumpeter cannot be targeted and will not attack. Trumpeter will use <color=#FF423F>Horn of the End</color> to instantly activate other Shadows' skills.
6. If all other Shadows are defeated	 Trumpeter will become targetable and begins preparing the <color=#FF423F>Horn of Ruin</color> for 2 turns.
Horn of Ruin: Sacrifices self to resummon all defeated Shadows	 greatly strengthening their abilities and dealing heavy damage to all Phantom Thieves.
901311	Wraith of Envy	The Wraith of Envy and its eyes share a <color=#FF423F>Soul Link</color>.
Soul Link: Distributes all damage received between all Shadows who share this condition	 based on the percentage of their current HP.
Each turn	 the Wraith of Envy will lock on to 1 Phantom Thief	 and deal heavy damage to that Phantom Thief on the next turn.
901411	Asura	The Four Heavenly Kings will activate their unique skills each turn.
1. Jikokuten has <color=#FF423F>Sword that Defends the Nation</color>.
Sword that Defends the Nation: Grants a shield to all Shadows. Lasts for 2 turns.
2. Zouchouten has <color=#FF423F>Growth of All Things</color>.
Growth of All Things: Permanently increases damage of all Shadows.
3. Koumokuten has <color=#FF423F>Eye of Heaven</color>.
Eye of Heaven: Selects 1 Phantom Thief. Increases their damage taken and has Shadows focus attacks on them next turn.
4. Bishamonten has <color=#FF423F>Parasol of Chaos</color>.
Parasol of Chaos: Covers the Shadow with the lowest HP	 and changes all affinities to Resist. Lasts for 2 turns.
930211	Unique Shadow Abilities	1. Genbu alternates between two skills	 <color=#FF423F>High Tide</color> and <color=#FF423F>Ebb Tide</color>.
2. Ebb Tide: Inflicts the <color=#FF423F>Submerged</color> status on 2 Phantom Thieves.
Clears all Shadows from the battle and summons 2 Decarabias and 2 Yurlungurs.
1. High Tide: Deals damage to all Phantom Thieves	 and inflicts the Submerged status on 1 Phantom Thief.
4. Submerged: Deals damage equal to 10% of max HP at the end of each turn.
Lasts 4 turns and can stack.
5. When Decarabia is defeated	 1 stack of Submerged will be removed.
During Ebb Tide	 each Decarabia will inflict 1 stacks of Submerged on all Phantom Thieves.
6. When Yurlungur is defeated	 all Phantom Thieves will heal 20% of their max HP	 and all Shadows will have their defense decreased for 2 turns.
During Ebb Tide	 each Yurlungur will heal all Shadows for 20% of their max HP.
930241	Unique Shadow Abilities	1. Genbu alternates between two skills	 <color=#FF423F>High Tide</color> and <color=#FF423F>Ebb Tide</color>.
2. Ebb Tide: Inflicts the <color=#FF423F>Submerged</color> status on 2 Phantom Thieves.
Clears all Shadows from the battle and summons 2 Decarabias and 2 Yurlungurs.
1. High Tide: Deals damage to all Phantom Thieves	 and inflicts the Submerged status on 1 Phantom Thief.
4. Submerged: Deals damage equal to 12.5% of max HP at the end of each turn.
Lasts 4 turns and can stack.
5. When Decarabia is defeated	 2 stack of Submerged will be removed.
During Ebb Tide	 each Decarabia will inflict 2 stacks of Submerged on all Phantom Thieves.
6. When Yurlungur is defeated	 all Phantom Thieves will heal 20% of their max HP	 and all Shadows will have their defense decreased for 2 turns.
During Ebb Tide	 each Yurlungur will heal all Shadows for 40% of their max HP.
930251	Unique Shadow Abilities	1. Genbu alternates between two skills	 <color=#FF423F>High Tide</color> and <color=#FF423F>Ebb Tide</color>.
2. Ebb Tide: Inflicts the <color=#FF423F>Submerged</color> status on 2 Phantom Thieves.
Clears all Shadows from the battle and summons 2 Decarabias and 2 Yurlungurs.
3. High Tide: Deals damage to all Phantom Thieves	 and inflicts the Submerged status on 1 Phantom Thief.
4. Submerged: Deals damage equal to 17.5% of max HP at the end of each turn.
Lasts 4 turns and can stack.
5. When Decarabia is defeated	 1 stack of Submerged will be removed.
During Ebb Tide	 each Decarabia will inflict 3 stacks of Submerged on all Phantom Thieves.
6. When Yurlungur is defeated	 all Phantom Thieves will heal 20% of their max HP	 and all Shadows will have their defense decreased for 2 turns.
During Ebb Tide	 each Yurlungur will heal all Shadows for 60% of their max HP.
931211	Unique Shadow Abilities	Raja Naga alternates between <color=#FF423F>Royal Decree</color> and <color=#FF423F>Royal Punishment</color>.
1. Royal Decree: Grants 3 stacks of <color=#FF423F>Royal Shield</color> to all Shadows.
Royal Shield: Damage taken decreases by 15%. Stacks up to 5 times.
Lose 1 stack when damaged by a skill	 Resonance	 or Highlight.
2. Royal Punishment: Locks on to a Phantom Thief	 and deals severe damage on the next turn.
If Raja Naga takes damage a total of 15 times from skills	 Resonances	 or Highlights	 the lock on will be lost.
3. Other Nagas cannot be defeated while Raja Naga is present.
931241	Unique Shadow Abilities	Raja Naga alternates between <color=#FF423F>Royal Decree</color> and <color=#FF423F>Royal Punishment</color>.
1. Royal Decree: Grants 3 stacks of <color=#FF423F>Royal Shield</color> to all Shadows.
Royal Shield: Damage taken decreases by 15%. Stacks up to 5 times.
Lose 1 stack when damaged by a skill	 Resonance	 or Highlight.
1. Royal Punishment: Locks on to a Phantom Thief	 and deals severe damage on the next turn.
If Raja Naga takes damage a total of 20 times from skills	 Resonances	 or Highlights	 the lock on will be lost.
3. <color=#FF423F>Royal Blessing</color>: When any Naga has more than 25% HP remaining	 its own damage is greatly increased.
Afterwards	 all other Nagas heal 50% of their HP.
4. At the start of each turn	 Raja Naga automatically gains 1 stack of Royal Shield.
5. Other Nagas cannot be defeated while Raja Naga is present.
901312	Wraith of Envy	<color=#FF423F>Wraith of Envy</color>:
1. While both of the Wraith of Envy's eyes are present	 all affinities will be Resist.
When both eyes have been defeated	 it enters a Weakened state and will take more damage.
2. When the Wraith of Envy's eyes are defeated	 they will revive after 3 turns.
3. The Wraith of Envy will gather power every other turn	 and on the next turn uses <color=#FF423F>Dark Whisper</color>	 dealing heavy Curse damage to all Phantom Thieves.
If both eyes are defeated while gathering power	 Dark Whisper will not be activated. If one eye is defeated while gathering power	 the damage of Dark Whisper will be decreased by 30%.
901313	Wraith of Envy	<color=#FF423F>Wraith of Envy</color>:
1. The Wraith of Envy and its eyes are in the <color=#FF423F>Soul Link</color> state.
Soul Link: Distributes all damage received between all Shadows who share this condition	 based on the percentage of their current HP.
2. The Wraith of Envy is Enraged	 and its damage increases every turn.
931251	Unique Shadow Abilities	Raja Naga alternates between <color=#FF423F>Royal Decree</color> and <color=#FF423F>Royal Punishment</color>.
1. Royal Decree: Grants 3 stacks of <color=#FF423F>Royal Shield</color> to all Shadows.
Royal Shield: Damage taken decreases by 15%. Stacks up to 5 times.
Lose 1 stack when damaged by a skill	 Resonance	 or Highlight.
2. Royal Punishment: Locks on to a Phantom Thief	 and deals severe damage on the next turn.
If Raja Naga takes damage a total of 25 times from skills	 Resonances	 or Highlights	 the lock on will be lost.
3. <color=#FF423F>Royal Blessing</color>: When any Naga has more than 25% HP remaining	 its own damage is greatly increased.
Afterwards	 all other Nagas heal 50% of their HP.
4. At the start of each turn	 Raja Naga automatically gains 2 stacks of Royal Shield.
5. Other Nagas cannot be defeated while Raja Naga is present.
901412	Asura	When the number of Four Heavenly Kings falls below 3	 they will sacrifice themselves to summon <color=#FF423F>Asura</color>.
Asura has the special skills of the sacrificed King (if there are less than 2 special skills	 it will gain another Royal special skill at random.
Asura activates its skill every turn.
901511	Trumpeter	1. At the start of battle	 Trumpeter summons the Four Horsemen	 and becomes invincible.
The Four Horsemen share a <color=#FF423F>Soul Link</color>	 and if all four are defeated	 Trumpeter will enter a Mania state.
Soul Link: Distributes all damage received between all Shadows who share this condition	 based on the percentage of their current HP.
2. Trumpeter and the Four Horsemen will sound their horns once every 3 turns. They cannot sound their horns if they are affected by a spiritual ailment.
3. White Rider: On Trumpeter's command	 it will sound the <color=#FF423F>Horn of Pestilence</color>	 decreasing the max HP of 1 random Phantom Thief.
4. Red Rider: On Trumpeter's command	 it will sound the <color=#FF423F>Horn of War</color>	 granting itself the Horn of War status.
When this status is active	 it will counterattack when attacked. Lasts for 1 turn.
5. Black Rider: On Trumpeter's command	 it will sound the <color=#FF423F>Horn of Famine</color>	 increasing the SP cost of skills for 1 random Phantom Thief.
6. Pale Rider: On Trumpeter's command	 it will sound the <color=#FF423F>Horn of Death</color>	 decreasing the healing effect of all Phantom Thieves' skills	 and increasing all Shadows' damage. Lasts for 2 turns.
7. Trumpeter: Each time the Four Horsemen sound a horn	 Trumpeter gains 1 stack of <color=#FF423F>Power of Ruin</color>.
After all Four Horsemen have been commanded	 Trumpeter will prepare for 1 turn before sounding the Horn of Ruin.
This will spend all stacks of Power of Ruin to deal Almighty damage to all Phantom Thieves (deals higher damage based on the Attack of all Four Horsemen).
Additional effects are based on the number of stacks of Power of Ruin.
1 stack: Final attack power increases by 25%.
2 stacks: Damage increases by 15%.
3 stacks: All Four Horsemen heal 10% of their HP.
4 stacks: This attack is guaranteed to be a Critical Hit.
901512	Trumpeter	8. After all Four Horsemen have been defeated once	 Trumpeter will enter a Mania state	 sacrificing 50% of its own HP to revive the Four Horsemen	 and becoming invincible again.
The Four Horsemen share a <color=#FF423F>Soul Link</color>	 and once they are defeated	 Trumpeter will lose its invincibility.
9. When in the Mania state	 Trumpeter does not spend Power of Ruin when it sounds the Horn of Ruin	 but still gains additional effects based on the number of stacks.
The number of stacks of Power of Ruin will increase the damage of all Shadows.
920011	Minami Miyashita's Skills	1. This Thief specializes in <color=#FF423F>healing</color> allies.
By gaining <color=#FF423F>Diagnosis</color>	 Marian can further increase her healing abilities to save her teammates from danger.
2. She can <color=#FF423F>increase max HP</color> and <color=#FF423F>remove debuffs</color>	 allowing her to boost her allies' survivability. Some skills can also provide continuous healing to allies over time.
3. She can grant <color=#FF423F>increased damage</color> to Phantom Thieves healed.
920111	Yusuke's Skills	1. This Thief specializes in <color=#FF423F>counterattacks</color> to deal heavy damage back at foes.
By enhancing his skills	 Fox's counterattacks can trigger with every attack taken	 and can target <color=#FF423F>all enemies</color>.
2. Skill damage is based on Fox's own <color=#FF423F>Defense</color>.
When he has a shield	 his attacks gain additional <color=#FF423F>Pierce Rate</color>	 making them even stronger.
3. Fox's powerful <color=#FF423F>Taunt ability</color> improves his counterattacks and survivability.
He can protect allies from taking powerful enemy attacks	 and then deal even greater damage with a counterattack.
920211	Yaoling's Skills	1. This Thief specializes in <color=#FF423F>inflicting debuffs on all foes</color>.
Rin can <color=#FF423F>lower Defense</color> and <color=#FF423F>increase damage taken</color>	 making her allies' attacks more effective.
2. During battle	 Rin can collect <color=#FF423F>Memories</color>	 allowing her to gain <color=#FF423F>Meng Po Soup</color>	 increasing the effectiveness of her debuff skills.
3. When foes are inflicted with <color=#FF423F>Forget</color>	 their attack skills are weakened.
920311	Haruna's Skills	1. This Thief specializes in <color=#FF423F>full-party buffs</color>.
Riddle can <color=#FF423F>increase Attack</color> and <color=#FF423F>damage dealt</color> for all of her teammates.
2. By teaming up with allies who have different <color=#FF423F>attack types</color> or who use <color=#FF423F>multi-hit attacks</color>	 the effects of her buffs on the whole party can be enhanced.
920411	Makoto's Skills	1. This Thief specializes in <color=#FF423F>single-target attacks</color>.
Queen can deal extra damage to foes with <color=#FF423F>elemental ailments</color>.
2. When certain conditions are met during battle	 she can enter the <color=#FF423F>Crash Out</color> state. Her <color=#FF423F>skills will be enhanced</color>	 greatly increasing her Attack and survivability.
3. She is able to <color=#FF423F>heal allies</color> while strengthening herself	 allowing her to turn the tide of combat.
920511	Yumi's Skills	1. This Thief specializes in <color=#FF423F>providing buffs to all allies</color>.
Phoebe can increase the team's <color=#FF423F>Attack</color> and <color=#FF423F>damage of specific Attributes</color>.
2. When allies deal damage	 Phoebe can create a <color=#FF423F>Mixer</color> of the same attribute	 and mix it together into a <color=#FF423F>Cocktail</color> that strengthens allies' skills.
When the team has multiple Phantom Thieves of the <color=#FF423F>same Attribute</color>	 the effect is stronger.
920711	Ren Amamiya's Skills	1. This Thief specializes in <color=#FF423F>multi-target attacks</color>. Joker can gain <color=#FF423F>Will of Rebellion</color> with certain attack skills and increase his own Attack. He can gain more <color=#FF423F>Will of Rebellion</color> during his turn after reducing the enemy's HP a certain amount.
2. With enough <color=#FF423F>Will of Rebellion</color>	 he gains an Extra Action and greatly increases his damage.
920811	Summer Motoha's Skills	1. This Thief specializes in <color=#FF423F>multi-target attacks</color>. When Closer is in the <color=#FF423F>Midsummer</color> state	 she receives a <color=#FF423F>damage bonus</color> and <color=#FF423F>critical rate increase</color>	 making her skills more powerful.
2. After receiving <color=#FF423F>healing</color>	 her skill <color=#FF423F>cooldown</color> is reduced	 and her abilities are improved.
3. Increases HP and Attack.
While increasing her survivability	 she also strengthens her attack power.
920911	Summer Tomoko's Skills	1. Summer Tomoko has excellent <color=#FF423F>healing and attack</color> capabilities.
After applying a certain number of <color=#FF423F>Sparklers</color> to foes	 she activates <color=#FF423F>Dazzling Fireworks</color>	 dealing damage to enemies while also healing allies.
Team up with allies who use <color=#FF423F>multi-target</color> or <color=#FF423F>multi-hit</color> attacks to build up Sparklers quickly.
2. She can increase her allies' <color=#FF423F>Attack</color> and <color=#FF423F>survivability</color>.
She can also reduce the damage dealt by enemies and increase their damage taken	 giving her <color=#FF423F>excellent support capability</color>.
921011	Yui's Skills	1. Bui specializes in <color=#FF423F>single-target attacks</color>.
After an ally uses an attack skill	 she has a chance to activate a <color=#FF423F>follow-up attack</color>.
2. Bui can select 1 ally to be <color=#FF423F>Player 2</color>.
When Bui uses a Highlight or selects a Player 2	 her follow-up attacks get even stronger.
3. She can deal increased damage against <color=#FF423F>Shocked</color> enemies.
921111	Kitazato's Skills	1. Messa specializes in <color=#FF423F>single-target Physical attacks</color>. During battle	 he can switch between 2 different attack modes by using <color=#FF423F>Nightfall</color> to use different skills.
921112	Kitazato's Skills	2. In <color=#FF423F>Hunter</color> mode	 Messa's skills will inflict <color=#FF423F>Bleed</color> on targets	 causing damage over time. It's especially effective against enemies with high HP.
3. In <color=#FF423F>Executioner</color> mode	 Messa deals higher Physical damage based on the number of <color=#FF423F>Bleed</color> stacks the enemy has.
228071	Unique Shadow Abilities	1. Every turn	 Kumbhanda will attack a Phantom Thief who has a <color=#FF423F>Grudge</color>.
If no Phantom Thieves have a Grudge	 it will attack all Phantom Thieves.
2. Whenever Kumbhanda attacks	 it reduces the target's HP by 20%	 and restores 20% HP to the Agathion with the lowest HP.
3. When Agathion is hit by an attack	 the attacker gains a Grudge.
Lasts for 1 turn.
4. If an Agathion's HP is less than 40% at the start of its turn	 it transforms into Kumbhanda.
If it is defeated	 it restores the HP of all Shadows by 40%.
228081	Unique Shadow Abilities	1. Every turn	 Kumbhanda will attack a Phantom Thief who has a <color=#FF423F>Grudge</color>.
If no Phantom Thieves have a Grudge	 it will attack all Phantom Thieves.
2. Whenever Kumbhanda attacks	 it reduces the target's SP by 20%	 and restores 10 SP to 1 random Agathion.
3. When Agathion is hit by an attack	 the attacker gains a Grudge.
Lasts for 1 turn.
4. If an Agathion's SP is less than 40% at the start of its turn	 it transforms into Kumbhanda.
If it is defeated	 it restores the SP of all Shadows by 40%.
228091	Unique Shadow Abilities	1. Each turn	 Girimehkala inflicts a <color=#FF423F>Mark of Calamity</color> on 2 Phantom Thieves. Lasts for 2 turns.
2. When a Phantom Thief with a Mark of Calamity deals damage with a skill	 <color=#FF423F>Arrival of Calamity</color> is activated on that Phantom Thief: Deals multi-target damage based on the user's Attack	 and inflicts a Mark of Calamity on the main target of the skill.
3. All Shadows take 60% decreased final damage from all attacks other than Arrival of Calamity.
4. After taking damage from Arrival of Calamity	 damage taken is greatly increased.
Lasts for 1 turn.
228101	Unique Shadow Abilities	1. Each turn	 Girimehkala inflicts a <color=#FF423F>Mark of Calamity</color> on 2 Phantom Thieves. Lasts for 2 turns.
2. When a Phantom Thief with a Mark of Calamity deals damage with a skill	 <color=#FF423F>Arrival of Calamity</color> is activated on that Phantom Thief.
Arrival of Calamity: Deals multi-target damage based on the user's Attack	 and inflicts a Mark of Calamity on the main target of the skill.
3. All Shadows take 60% decreased final damage from all attacks other than Arrival of Calamity.
4. Up to 2 Marks of Calamity can be held.
When Mark of Calamity reaches 2 stacks	 using a skill will activate Ruinous Calamity once	 dealing severe damage.
This effect does not inflict a Mark of Calamity on the target.
228111	Unique Shadow Abilities	1. Each turn	 Girimehkala inflicts a <color=#FF423F>Mark of Calamity</color> on 2 Phantom Thieves and 1 Shadow.
Lasts for 2 turns.
2. When a Phantom Thief with a Mark of Calamity deals damage with a skill	 <color=#FF423F>Arrival of Calamity</color> is activated on that Phantom Thief.
Arrival of Calamity: Deals multi-target damage based on the user's Attack	 and inflicts a Mark of Calamity on the main target of the skill.
3. All Shadows take 60% decreased final damage from all attacks other than Arrival of Calamity.
4. When Girimehkala has a Mark of Calamity	 its damage is permanently increased by 50% after attacking.
5. When Incubus has a Mark of Calamity	 it heals all Shadows after attacking.
6. If Succubus has a Mark of Calamity	 it will inflict <color=#FF423F>Dizzy</color> on 1 Phantom Thief after attacking.
7. If Oni has a Mark of Calamity	 it greatly increases the damage of another Shadow after attacking.
228121	Unique Shadow Abilities	1. Belphegor is always <color=#FF423F>Asleep</color>.
After being attacked	 he will wake up	 and can take 1 action before going back to sleep.
2. Each time Belphegor acts	 it gains 1 stack of <color=#FF423F>Irate</color>	 and its damage increases.
3. When Sandman is defeated	 Belphegor will fall asleep.
228131	Unique Shadow Abilities	1. Belphegor is always <color=#FF423F>Asleep</color>.
After being attacked	 he will wake up	 and can take 1 action before going back to sleep.
2. Belphegor takes increased damage while Asleep.
Every 2 turns	 it summons 1 Sandman.
3. When Sandman is defeated	 Belphegor will fall asleep.
228141	Unique Shadow Abilities	1. Belphegor is always <color=#FF423F>Asleep</color>.
After being attacked	 he will wake up	 and can take 1 action before going back to sleep.
2. Belphegor deals increased damage to Sleeping targets.
3. Every turn	 Sandman will choose 1 random target and put them to Sleep. Lasts for 2 turns.
4. The first time Decarabia takes damage each turn	 it will counterattack all targets 1 time.
228151	Unique Shadow Abilities	1. At the start of battle	 3 Warriors will appear.
When the Warriors are defeated	 Valkyrie will receive a buff	 and 1 more of the same Warrior will reappear.
2. When 3 Warriors have been defeated	 the Warriors will leave and Valkyrie will appear.
3. When Setanta is defeated	 Valkyrie receives the following effect: At the end of the turn	 restores 20% of HP. Stacks up to 3 times.
4. When Cu Chulainn is defeated	 Valkyrie receives the following effect: When using a skill	 all Phantom Thieves are inflicted with <color=#FF423F>Army of Ruin</color>.
Army of Ruin: After acting	 take damage equal to 30% of HP.
Stacks up to 3 times.
5. When Narcissus is defeated	 Valkyrie receives the following effect: After using a skill	 makes 1 additional follow-up attack on the Phantom Thief with the lowest HP.
228161	Unique Shadow Abilities	1. At the start of battle	 3 Warriors will appear.
When the Warriors are defeated	 Valkyrie will receive a buff	 and 1 more of the same Warrior will reappear.
2. When 3 Warriors have been defeated	 the Warriors will leave and Valkyrie will appear.
3. When Setanta is defeated	 Valkyrie receives the following effect: When using a skill	 Attack is greatly increased.
Lasts for 2 turns. Stacks up to 3 times.
4. When Cu Chulainn is defeated	 Valkyrie receives the following effect: After attacking	 all Phantom Thieves' damage taken is increased.
Lasts for 2 turns. Stacks up to 3 times.
5. When Narcissus is defeated	 Valkyrie receives the following effect: After using a skill	 makes an additional multi-target follow-up attack.
Stacks up to 3 times.
829071	Unique Shadow Abilities	1. Pazuzu's skills can inflict <color=#FF423F>Plague Curse</color>.
Plague Curse: Deals damage equal to 5% of HP at the end of the turn.
2. Pazuzu uses <color=#FF423F>Spreading Sickness</color> every other turn.
Spreading Sickness: Inflicts 2 Plague Curse stacks on all Phantom Thieves	 with a high chance of inflicting spiritual ailments.
3. Pazuzu uses <color=#FF423F>Eternal Binding</color> every other turn.
Eternal Binding: Inflicts 2 Plague Curse stacks on all Phantom Thieves	 and removes 1 Plague Curse stack from the target.
4. When Pale Rider attacks	 it inflicts 1 Plague Curse stack on Shadows.
While Pale Rider is present	 Pazuzu's final damage taken is reduced by 30%.
5. When Sudama is defeated	 all Phantom Thieves' ailment resistance is increased by 100%.
Lasts for 2 turns.
829081	Unique Shadow Abilities	1. Pazuzu's skills can inflict <color=#FF423F>Plague Curse</color>.
Plague Curse: Deals damage equal to 5% of HP at the end of the turn.
2. Pazuzu uses <color=#FF423F>Spreading Sickness</color> every other turn.
Spreading Sickness: Inflicts 2 Plague Curse stacks on all Phantom Thieves	 and inflicts 2 Plague Curse stacks on Pixie.
3. Pazuzu uses <color=#FF423F>Eternal Binding</color> every other turn.
Eternal Binding: Inflicts 2 Plague Curse stacks on all Phantom Thieves	 and removes 1 Plague Curse stack from the target.
4. When Pale Rider attacks	 it inflicts 1 Plague Curse stack on Shadows.
While Pale Rider is present	 Pazuzu's final damage taken is reduced by 30%.
5. When Pixie uses a skill	 all Phantom Thieves have 1 Plague Curse stack removed.
829091	Unique Shadow Abilities	1. Pazuzu's skills can inflict <color=#FF423F>Plague Curse</color>.
Plague Curse: Deals damage equal to 5% of HP at the end of the turn.
2. Pazuzu uses <color=#FF423F>Spreading Sickness</color> every other turn.
Spreading Sickness: Inflicts Plague Origin on 1 Black Ooze. Lasts for 2 turns.
3. After a Shadow with <color=#FF423F>Plague Origin</color> attacks	 all Phantom Thieves are inflicted with 2 Plague Curse stacks.
After being defeated	 Pazuzu is inflicted with 2 Plague Curse stacks.
4. Pazuzu uses <color=#FF423F>Eternal Binding</color> every other turn.
Eternal Binding: Inflicts 2 Plague Curse stacks on all Phantom Thieves	 and removes 1 Plague Curse stack from the target.
829101	Unique Shadow Abilities	1. Horus is blessed by the Sun God	 and at the end of each turn it gains 1 <color=#FF423F>Power of the Sun</color>.
Power of the Sun: Damage taken decreased by 20%.
2. If Horus has Power of the Sun at the beginning of its turn	 it deals heavy Almighty damage to all Phantom Thieves.
Damage increases based on the number of stacks of Power of the Sun.
3. Kushi Mitama has the power of the Moon God	 and removes 1 stack of Power of the Sun from Horus every turn. In exchange	 it loses 34% of its max HP.
829111	Unique Shadow Abilities	1. Horus is blessed by the Sun God	 and at the end of each turn it gains 1 <color=#FF423F>Power of the Sun</color>.
Power of the Sun: Damage taken decreased by 20%.
2. If Horus has Power of the Sun at the beginning of its turn	 it deals heavy Almighty damage to all Phantom Thieves.
Damage increases based on the number of stacks of Power of the Sun.
3. The Left Eye of Horus removes 1 Power of the Sun from Horus each turn. In exchange	 it loses 34% of its max HP.
4. The Right Eye of Horus grants 3 stacks of Power of the Sun to Horus when it is defeated.
829121	Unique Shadow Abilities	1. Horus is blessed by the Sun God	 and at the end of each turn it gains 1 <color=#FF423F>Power of the Sun</color>.
Power of the Sun: Final damage taken decreased by 20%.
2. If Horus has Power of the Sun at the beginning of its turn	 it deals heavy Almighty damage to all Phantom Thieves.
Damage increases based on the number of stacks of Power of the Sun.
3. The Left Eye of Horus removes 1 Power of the Sun from Horus each turn.
In exchange	 it loses 34% of its max HP.
4. The Right Eye of Horus grants 1 Power of the Sun to Horus each turn.
If it is defeated	 Horus loses all stacks of Power of the Sun.
5. The Right Eye of Horus removes all continuous damage effects on Horus at the start of its turn.
For each effect removed	 Horus takes 3% of its max HP as damage (this is affected by Horus' final damage reduction).
6. The Right Eye of Horus has <color=#FF423F>Protection of Horus</color>	 which decreases damage taken outside of its own turn by 60%	 but increases damage taken during its own turn by 300%.
7. If only the Left Eye of Horus remains on the field	 it transforms into Seth and takes control of the field.
932211	Unique Shadow Abilities	1. Unicorn will activate <color=#FF423F>Sacred Blessing</color>.
Sacred Blessing: Deals Bless damage to all Phantom Thieves	 gains 10 stacks of <color=#FF423F>Purity</color>	 and summons 1 Emperor's Amulet.
2. Unicorn will activate <color=#FF423F>Sacred Radiance</color> 2 turns after activating Sacred Blessing.
Sacred Radiance: Deals heavy damage to all Phantom Thieves based on the number of Purity stacks.
If there are 5 stacks of Purity or more	 Phantom Thieves will also be inflicted with <color=#FF423F>Rebuke</color>.
Rebuke: Permanently increases damage taken by 50%.
3. Each stack of Purity decreases Unicorn's damage taken by 5% for each stack. Lose 1 stack for each status ailment inflicted.
4. When Emperor's Amulet is inflicted with a status ailment	 the same ailment is inflicted on Unicorn	 and 1 stack of Purity is removed.
5. Emperor's Talisman will die after 1 action	 and Unicorn will take damage equal to the HP lost by Emperor's Talisman.
932241	Unique Shadow Abilities	1. Unicorn will activate <color=#FF423F>Sacred Blessing</color>.
Sacred Blessing: Deals Bless damage to all Phantom Thieves	 gains 15 stacks of <color=#FF423F>Purity</color>	 and summons 1 Emperor's Amulet.
2. Unicorn will activate <color=#FF423F>Sacred Radiance</color> 2 turns after activating Sacred Blessing.
Sacred Radiance: Deals heavy damage to all Phantom Thieves based on the number of Purity stacks.
If there are 5 stacks of Purity or more	 Phantom Thieves will also be inflicted with <color=#FF423F>Rebuke</color>.
Rebuke: Permanently increases damage taken by 50%.
3. Each stack of Purity decreases Unicorn's damage taken by 5% for each stack. Lose 1 stack for each status ailment inflicted.
4. When Emperor's Amulet is inflicted with a status ailment	 the same ailment is inflicted on Unicorn	 and 1 stack of Purity is removed.
5. Emperor's Talisman will die after 1 action	 and Unicorn will take damage equal to the HP lost by Emperor's Talisman.
932251	Unique Shadow Abilities	1. Unicorn will activate <color=#FF423F>Sacred Blessing</color>.
Sacred Blessing: Deals Bless damage to all Phantom Thieves	 gains 25 stacks of <color=#FF423F>Purity</color>	 and summons 1 Emperor's Amulet.
2. Unicorn will activate <color=#FF423F>Sacred Radiance</color> 2 turns after activating Sacred Blessing.
Sacred Radiance: Deals heavy damage to all Phantom Thieves based on the number of Purity stacks.
If there are 5 stacks of Purity or more	 Phantom Thieves will also be inflicted with <color=#FF423F>Rebuke</color>.
Rebuke: Permanently increases damage taken by 50%.
3. Each stack of Purity decreases Unicorn's damage taken by 5% for each stack. Lose 1 stack for each status ailment inflicted.
4. When Emperor's Amulet is inflicted with a status ailment	 the same ailment is inflicted on Unicorn	 and 1 stack of Purity is removed.
5. Emperor's Talisman will die after 1 action	 and Unicorn will take damage equal to the HP lost by Emperor's Talisman.
914501	Moha	1. After acting each turn	 if Moha has taken damage during that turn	 its <color=#FF423F>Wrath</color> increases by 4.
If it has not taken damage during the turn	 its Wrath decreases by 1.
2. If Moha's Wrath reaches 12 by the end of the turn	 it will spend all Wrath to use <color=#FF423F>Rapid Ascent</color>	 and on the next turn	 uses <color=#FF423F>Sphinx Dive</color> to deal heavy Physical damage to all Phantom Thieves.
3. When Moha is on the field	 the Phantom Thieves gain a small amount of Ballista Energy at the end of each turn.
4. When the Phantom Thieves deal weakness damage to Moha	 they gain a large amount of <color=#FF423F>Ballista Energy</color>. This can be done only once per turn.
5. When the Phantom Thieves have 100 Ballista Energy at the start of the turn	 they will spend 100 Ballista Energy to attack Moha with a <color=#FF423F>Ballista Shot</color>	 putting it in a Weakened state and causing it to lose all Wrath.
921211	Futaba's Skills	1. Oracle specializes in <color=#FF423F>multi-target debuff skills</color>. She can inflict <color=#FF423F>Disrupting Virus</color> on all foes to manipulate their affinities.
2. She can decrease the defense and increase the damage taken by enemies	 and can use an additional debuff to increase the damage taken from their weakness.
3. During battle	 she can collect <color=#FF423F>Clues</color> to activate <color=#FF423F>Analysis Complete</color>	 increasing damage for all her allies and granting them a <color=#FF423F>shield</color>.
921311	Ashiya's Skills	1. Cherish specializes in <color=#FF423F>boosting the Defense of allies</color>.
He can grant his allies a <color=#FF423F>shield</color> or increase their Defense to improve their survivability.
2. During battle	 he can use <color=#FF423F>Emblem of Honesty</color> to protect allies from damage and gain <color=#FF423F>Heroism</color> to activate <color=#FF423F>Declaration of Justice</color>.
3. Declaration of Justice strengthens skills	 and further increases the Attack and survivability of allies.
933211	Unique Shadow Abilities	1. Hell Biker alternates between <color=#FF423F>Hellfire</color> and <color=#FF423F>Cleansing Flame</color>.
2. Hellfire: Deals heavy Fire damage to all Phantom Thieves	 and inflicts <color=#FF423F>Hellscorched</color> if the target's HP is low.
Hellscorched: Take damage equal to 35% of max HP each turn.
3. Cleansing Flame: Deals heavy Fire damage to the Phantom Thief with the highest Attack	 permanently decreases Attack by 50%	 and increases Hell Biker's Attack by 30%.
4. Oni and Hell Biker have the <color=#FF423F>Soul Link</color> condition.
5. Oni will prioritize attacking the Phantom Thief with the lowest HP.
921411	Haru's Skills	1. This Thief specializes in <color=#FF423F>multi-target attacks</color>.
By using certain skills	 Noir gains <color=#FF423F>Reform</color>	 allowing her to deal powerful Psychokinesis damage with long-range attacks.
2. Each skill Noir activates will give different types of Reform.
Each one will <color=#FF423F>enhance her long-range attacks</color> in various ways.
3. By increasing Noir's ailment accuracy	 she can not only gain increased Attack and critical damage	 she can also improve the accuracy of her <color=#FF423F>Marked</color> effect.
915501	Avidya's Skills	1. Avidya cannot be targeted in the first phase of battle	 and will continuously summon Corporobos to fight the Phantom Thieves.
After a certain number of Corporobos have been defeated	 Avidya will move to the second phase.
2. Avidya cannot be targeted in the second phase of battle	 and will summon a team of powerful Corporobos to fight.
When all of the Corporobos have been defeated	 Avidya will move to the third phase	 where he can be targeted and will not use any skills.
3. During the battle	 Avidya will use <color=#FF423F>Selfless Devotion</color> on randomly selected Corporobos	 who will self-destruct after 2 turns	 dealing heavy damage to the Phantom Thieves.
4. Corporobo MDL-CH will use Overtime Order on the Shadow with the highest Attack	 granting it an extra turn.
5. Corporobo MDL-DM will use <color=#FF423F>Performance Evaluation</color> on the Shadow with the lowest Attack	 increasing its Attack	 and promoting it to a Corporobo MDL-AM after 2 turns.
6. Corporobo MDL-GM uses skills to buff and heal Shadows.
7. Corporobo MDL-ED will use <color=#FF423F>Team-Building Exercise</color> to drain all other Shadows' HP to strengthen itself.
921511	Slow Dance Kotone's Skills	1. Mont specializes in <color=#FF423F>single-target attacks</color>. During battle	 she can switch between <color=#FF423F>Wind Form</color> and <color=#FF423F>Ice Form</color>	 allowing her to use different skills.
2. During battle	 she can create a barrier to collect Ice Crystals	 and then spend Ice Crystals to shatter the barrier and unleash a powerful Resonance on enemies.
3. When a Phantom Thief with the same Attribute uses skills	 more Ice Crystals can be collected	 and Mont will deal more damage.
934211	Unique Shadow Abilities	1. Shiki-Ouji changes forms every turn.
2. In Defense Form	 Shiki-Ouji permanently gains 5 <color=#FF423F>Defensive Stance</color> stacks.
Defensive Stance: Damage taken is decreased by 10%. Lose 1 stack when taking weakness damage.
3. In Attack Form	 Shiki-Ouji will act twice	 and each stack of Defensive Stance increases its damage by 25%.
238011	Unique Shadow Abilities	1. Seiryu alternates between inflicting weaknesses to Psychokinesis and Nuclear. These effects last for 2 turns.
2. When a Shadow is defeated	 Seiryu gains 1 stack of <color=#FF423F>Azure Storm</color>.
Azure Storm: Damage increases by 30%.
When Azure Storm reaches 6 stacks	 Seiryu deals heavy damage.
3. Every 2 turns	 Seiryu summons 1 Phoenix and 1 Leanan Sidhe.
Phoenix uses Nuclear skills	 and Leanan Sidhe uses Psychokinesis skills.
238021	Unique Shadow Abilities	1. Seiryu alternates between inflicting weaknesses to Wind and Ice. These effects last for 2 turns.
2. When a Shadow is defeated	 Seiryu gains 1 stack of <color=#FF423F>Azure Storm</color>.
Azure Storm: Damage increases by 30%.
When Azure Storm reaches 6 stacks	 Seiryu deals heavy damage.
3. At the start of the turn	 if there are no Sudama or Kodama on the field	 1 Sudama or Kodama will be summoned.
238031	Unique Shadow Abilities	1. Each turn	 Seiryu will record the attributes of damage it takes	 and on the next turn inflicts a weakness to that attribute to a Shadow.
2. When a Shadow is defeated	 Seiryu gains 1 stack of <color=#FF423F>Azure Storm</color>.
Azure Storm: Damage increases by 30%.
When Azure Storm reaches 6 stacks	 Seiryu deals heavy damage.
238041	Unique Shadow Abilities	1. Raja Naga alternates between <color=#FF423F>Royal Blessing</color> and <color=#FF423F>Royal Punishment</color>.
2. Royal Blessing: Greatly strengthens 1 Shadow	 and when that Shadow attacks	 it can inflict <color=#FF423F>Brainwash</color> on 1 Phantom Thief.
3. Royal Punishment: Locks on to a Phantom Thief	 and deals heavy damage on the next turn.
If Shadows take damage from 4 different attribute types	 the lock on will be lost.
238051	Unique Shadow Abilities	1. Raja Naga alternates between <color=#FF423F>Royal Blessing</color> and <color=#FF423F>Royal Punishment</color>.
2. Royal Blessing: Greatly strengthens 1 Shadow	 and when that Shadow attacks	 all Shadows' ailment resistance is increased.
3. Royal Punishment: Locks on to the Phantom Thief with the highest Attack	 and deals heavy damage on the next turn.
If Shadows are inflicted with a total of 15 debuffs	 the lock on will be lost.
238061	Unique Shadow Abilities	1. Byakko alternates between <color=#FF423F>Byakko's Claw</color> and <color=#FF423F>Byakko's Fang</color>.
2. Byakko's Claw: Deals damage to 1 target and inflicts <color=#FF423F>Deep Wounds</color>.
This effect deals damage over time	 and can be removed by receiving healing 3 times.
3. Byakko's Fang: Deals damage to all targets and inflicts <color=#FF423F>Bite Marks</color>.
This effect increases damage taken	 and can be removed by dealing damage 3 times.
4. At the start of each turn	 if both Deep Wounds and Bite Marks have been inflicted	 Byakko will activate <color=#FF423F>Prey</color>	 dealing heavy damage and inflicting <color=#FF423F>Despair</color> on the target.
5. Every 2 turns	 1 Leanan Sidhe will be summoned.
238071	Unique Shadow Abilities	1. Byakko alternates between <color=#FF423F>Byakko's Claw</color> and <color=#FF423F>Byakko's Fang</color>.
2. Byakko's Claw: Deals damage to 1 target and inflicts <color=#FF423F>Deep Wounds</color>.
This effect deals damage over time.
3. Byakko's Fang: Deals damage to all targets and inflicts <color=#FF423F>Bite Marks</color>.
This effect increases damage taken.
4. At the start of each turn	 if both Deep Wounds and Bite Marks have been inflicted	 Byakko will activate <color=#FF423F>Prey</color>	 dealing heavy damage and inflicting <color=#FF423F>Despair</color> on the target.
5. Every 2 turns	 Byakko selects 1 Sudama as Bait	 and on the next turn	 eats the Sudama	 fully restoring its HP and granting itself a buff.
238081	Unique Shadow Abilities	1. Byakko alternates between <color=#FF423F>Byakko's Claw</color> and <color=#FF423F>Byakko's Fang</color>.
2. Byakko's Claw: Deals damage to 1 target and inflicts <color=#FF423F>Deep Wounds</color>.
This effect deals damage over time	 and can be removed by inflicting an elemental or spiritual ailment.
3. Byakko's Fang: Deals damage to all targets and inflicts <color=#FF423F>Bite Marks</color>.
This effect increases damage taken and can be removed by activating a Highlight or Resonance.
4. At the start of each turn	 if both Deep Wounds and Bite Marks have been inflicted	 Byakko will activate <color=#FF423F>Prey</color>	 dealing heavy damage and inflicting Despair</color> on the target.
5. Every 2 turns	 Byakko summons 1 Byakko's Afterimage.
Byakko's Afterimage has the same skills	 but very low HP and ailment resistance.
920611	AAAAAA==	Placeholder
